MTMR11	lof_ch_genes
SOAT1	lof_ch_genes
ASPM	lof_ch_genes
COL16A1	lof_ch_genes
TNNI3K	lof_ch_genes
HAO2	lof_ch_genes
ZP4	lof_ch_genes
GBP1	lof_ch_genes
CR2	lof_ch_genes
RSRP1	lof_ch_genes
RGSL1	lof_ch_genes
ODF2L	lof_ch_genes
RAB25	lof_ch_genes
CAPN9	lof_ch_genes
MMEL1	lof_ch_genes
CFAP74	lof_ch_genes
FHAD1	lof_ch_genes
PADI1	lof_ch_genes
SYTL1	lof_ch_genes
FNDC7	lof_ch_genes
ADCY10	lof_ch_genes
CGN	lof_ch_genes
DTL	lof_ch_genes
ADAM15	lof_ch_genes
OBSCN	lof_ch_genes
CHRNB2	lof_ch_genes
DRAXIN	lof_ch_genes
TMCO4	lof_ch_genes
MEGF6	lof_ch_genes
CCDC27	lof_ch_genes
PGLYRP4	lof_ch_genes
IGFN1	lof_ch_genes
PCSK9	lof_ch_genes
LUZP1	lof_ch_genes
PLEKHG5	lof_ch_genes
SLFNL1	lof_ch_genes
SELP	lof_ch_genes
RNPEP	lof_ch_genes
HTR1D	lof_ch_genes
FCRL6	lof_ch_genes
CLCNKA	lof_ch_genes
ANKRD35	lof_ch_genes
PRAMEF17	lof_ch_genes
DISP3	lof_ch_genes
CYB5RL	lof_ch_genes
C1orf167	lof_ch_genes
FPGT-TNNI3K	lof_ch_genes
GCFC2	lof_ch_genes
MYO3B	lof_ch_genes
MPP4	lof_ch_genes
APOB	lof_ch_genes
NLRC4	lof_ch_genes
IFIH1	lof_ch_genes
GCA	lof_ch_genes
DNAH6	lof_ch_genes
PASK	lof_ch_genes
TAF1B	lof_ch_genes
QPCT	lof_ch_genes
PCYOX1	lof_ch_genes
ALMS1	lof_ch_genes
DNAH7	lof_ch_genes
CYP20A1	lof_ch_genes
METTL8	lof_ch_genes
TNFAIP6	lof_ch_genes
MOGAT1	lof_ch_genes
OBSL1	lof_ch_genes
OSGEPL1	lof_ch_genes
TTLL4	lof_ch_genes
ANKRD36	lof_ch_genes
GALNT5	lof_ch_genes
ASNSD1	lof_ch_genes
FASTKD1	lof_ch_genes
UNC80	lof_ch_genes
ANKMY1	lof_ch_genes
ANKAR	lof_ch_genes
G6PC2	lof_ch_genes
PLEKHH2	lof_ch_genes
TTN	lof_ch_genes
DRC1	lof_ch_genes
XDH	lof_ch_genes
CCDC138	lof_ch_genes
CCDC74A	lof_ch_genes
TEKT4	lof_ch_genes
BBS5	lof_ch_genes
PLB1	lof_ch_genes
ASB18	lof_ch_genes
KIAA2012	lof_ch_genes
NEB	lof_ch_genes
MROH2A	lof_ch_genes
FSIP2	lof_ch_genes
WDSUB1	lof_ch_genes
VIT	lof_ch_genes
RAD51AP2	lof_ch_genes
CROCC2	lof_ch_genes
FAM237A	lof_ch_genes
UGT1A3	lof_ch_genes
AC093899.2	lof_ch_genes
DLEC1	lof_ch_genes
STAB1	lof_ch_genes
POLQ	lof_ch_genes
MCF2L2	lof_ch_genes
ITIH1	lof_ch_genes
EHHADH	lof_ch_genes
PCCB	lof_ch_genes
EFCC1	lof_ch_genes
DNAH1	lof_ch_genes
IRAK2	lof_ch_genes
CNTN6	lof_ch_genes
FANCD2	lof_ch_genes
MYH15	lof_ch_genes
MUC4	lof_ch_genes
ABI3BP	lof_ch_genes
XPC	lof_ch_genes
TRIM42	lof_ch_genes
ERICH6	lof_ch_genes
MST1R	lof_ch_genes
ULK4	lof_ch_genes
SCN11A	lof_ch_genes
RIOX2	lof_ch_genes
COL6A5	lof_ch_genes
WDR49	lof_ch_genes
ATR	lof_ch_genes
GPR156	lof_ch_genes
SCN10A	lof_ch_genes
ZNF501	lof_ch_genes
ATP13A5	lof_ch_genes
KBTBD12	lof_ch_genes
VEPH1	lof_ch_genes
COL6A6	lof_ch_genes
TTLL3	lof_ch_genes
ARPC4-TTLL3	lof_ch_genes
CD38	lof_ch_genes
RFC1	lof_ch_genes
FAM184B	lof_ch_genes
SH3BP2	lof_ch_genes
WFS1	lof_ch_genes
SH3TC1	lof_ch_genes
CPEB2	lof_ch_genes
CORIN	lof_ch_genes
SPATA4	lof_ch_genes
TDO2	lof_ch_genes
TMPRSS11D	lof_ch_genes
UGT2A1	lof_ch_genes
TLR1	lof_ch_genes
AMBN	lof_ch_genes
DDX60L	lof_ch_genes
FREM3	lof_ch_genes
ADH1B	lof_ch_genes
DTHD1	lof_ch_genes
DCHS2	lof_ch_genes
CNGA1	lof_ch_genes
C4orf54	lof_ch_genes
ASIC5	lof_ch_genes
UGT2A2	lof_ch_genes
CDHR2	lof_ch_genes
DELE1	lof_ch_genes
SLC4A9	lof_ch_genes
MSH3	lof_ch_genes
ATP10B	lof_ch_genes
ARAP3	lof_ch_genes
POLK	lof_ch_genes
SPINK5	lof_ch_genes
ADAM19	lof_ch_genes
OTULINL	lof_ch_genes
IQGAP2	lof_ch_genes
ADAMTS12	lof_ch_genes
SPEF2	lof_ch_genes
PLEKHG4B	lof_ch_genes
HK3	lof_ch_genes
SLC45A2	lof_ch_genes
BTNL9	lof_ch_genes
GPR151	lof_ch_genes
PHYKPL	lof_ch_genes
LRRC70	lof_ch_genes
CPLANE1	lof_ch_genes
FCHSD1	lof_ch_genes
RANBP17	lof_ch_genes
ITGA1	lof_ch_genes
KIF4B	lof_ch_genes
PCDHAC1	lof_ch_genes
PCDHGA5	lof_ch_genes
PCDHGB3	lof_ch_genes
ROS1	lof_ch_genes
OPRM1	lof_ch_genes
SLC26A8	lof_ch_genes
ZNF451	lof_ch_genes
GPLD1	lof_ch_genes
CRYBG1	lof_ch_genes
VNN1	lof_ch_genes
FIG4	lof_ch_genes
CCDC170	lof_ch_genes
TTLL2	lof_ch_genes
USP45	lof_ch_genes
DNAH8	lof_ch_genes
COL21A1	lof_ch_genes
MDC1	lof_ch_genes
AK9	lof_ch_genes
SAMD3	lof_ch_genes
PI16	lof_ch_genes
KIF6	lof_ch_genes
SLC22A1	lof_ch_genes
TDRD6	lof_ch_genes
THBS2	lof_ch_genes
ECT2L	lof_ch_genes
CFTR	lof_ch_genes
ABCB5	lof_ch_genes
SLC25A13	lof_ch_genes
CROT	lof_ch_genes
ASB4	lof_ch_genes
CHPF2	lof_ch_genes
SLC13A1	lof_ch_genes
DNAH11	lof_ch_genes
IQCE	lof_ch_genes
HSPB1	lof_ch_genes
CYP3A5	lof_ch_genes
HYAL4	lof_ch_genes
ASL	lof_ch_genes
CPA4	lof_ch_genes
ADCK2	lof_ch_genes
KCP	lof_ch_genes
SPDYE1	lof_ch_genes
GPNMB	lof_ch_genes
MMD2	lof_ch_genes
VWDE	lof_ch_genes
SLC12A9	lof_ch_genes
LRGUK	lof_ch_genes
PKD1L1	lof_ch_genes
CDCA7L	lof_ch_genes
MUC17	lof_ch_genes
AMZ1	lof_ch_genes
ABCA13	lof_ch_genes
ZNF467	lof_ch_genes
GSTK1	lof_ch_genes
GNAT3	lof_ch_genes
LRRD1	lof_ch_genes
MGAM	lof_ch_genes
POM121C	lof_ch_genes
MYOM2	lof_ch_genes
TG	lof_ch_genes
ADAM28	lof_ch_genes
CDH17	lof_ch_genes
FZD3	lof_ch_genes
TRPA1	lof_ch_genes
TNFRSF10A	lof_ch_genes
UBXN8	lof_ch_genes
SORBS3	lof_ch_genes
TEX15	lof_ch_genes
DSCC1	lof_ch_genes
MCPH1	lof_ch_genes
PXDNL	lof_ch_genes
NAPRT	lof_ch_genes
DPY19L4	lof_ch_genes
LETM2	lof_ch_genes
C8orf34	lof_ch_genes
CNGB3	lof_ch_genes
TRHR	lof_ch_genes
MSRA	lof_ch_genes
FBXL6	lof_ch_genes
RP1L1	lof_ch_genes
TOP1MT	lof_ch_genes
CDCA2	lof_ch_genes
COL14A1	lof_ch_genes
NUGGC	lof_ch_genes
PKHD1L1	lof_ch_genes
KCNU1	lof_ch_genes
OC90	lof_ch_genes
AC100868.1	lof_ch_genes
NUDT18	lof_ch_genes
PRUNE2	lof_ch_genes
SUSD1	lof_ch_genes
KANK1	lof_ch_genes
APBA1	lof_ch_genes
CNTRL	lof_ch_genes
ACO1	lof_ch_genes
DDX31	lof_ch_genes
WDR31	lof_ch_genes
HMCN2	lof_ch_genes
CCDC171	lof_ch_genes
CERCAM	lof_ch_genes
ANKRD20A4P	lof_ch_genes
TPRN	lof_ch_genes
SSNA1	lof_ch_genes
DPP7	lof_ch_genes
MAMDC4	lof_ch_genes
EXD3	lof_ch_genes
FOCAD	lof_ch_genes
NOXA1	lof_ch_genes
CCDC180	lof_ch_genes
GSTO2	lof_ch_genes
SEC31B	lof_ch_genes
NEBL	lof_ch_genes
WASHC2A	lof_ch_genes
CUBN	lof_ch_genes
CDH23	lof_ch_genes
SFXN3	lof_ch_genes
PITRM1	lof_ch_genes
SORCS1	lof_ch_genes
CFAP58	lof_ch_genes
MYOF	lof_ch_genes
LOXL4	lof_ch_genes
ADAM8	lof_ch_genes
ITIH2	lof_ch_genes
C10orf90	lof_ch_genes
MARCHF8	lof_ch_genes
CFAP46	lof_ch_genes
MMRN2	lof_ch_genes
PTCHD3	lof_ch_genes
AKR1C1	lof_ch_genes
ASAH2	lof_ch_genes
AKR1C3	lof_ch_genes
MALRD1	lof_ch_genes
USH1C	lof_ch_genes
CD44	lof_ch_genes
DGAT2	lof_ch_genes
VWA5A	lof_ch_genes
APOA4	lof_ch_genes
USP35	lof_ch_genes
SNX19	lof_ch_genes
TPH1	lof_ch_genes
RRP8	lof_ch_genes
C11orf1	lof_ch_genes
PDE3B	lof_ch_genes
NLRP14	lof_ch_genes
NLRX1	lof_ch_genes
PPP1R32	lof_ch_genes
DEUP1	lof_ch_genes
ALKBH3	lof_ch_genes
MMP10	lof_ch_genes
SAAL1	lof_ch_genes
C2CD3	lof_ch_genes
SNX32	lof_ch_genes
NLRP6	lof_ch_genes
RPS6KB2	lof_ch_genes
DNHD1	lof_ch_genes
C11orf54	lof_ch_genes
OVCH2	lof_ch_genes
IRF7	lof_ch_genes
LMNTD2	lof_ch_genes
TRIM64B	lof_ch_genes
SLC22A25	lof_ch_genes
MFRP	lof_ch_genes
POLR3B	lof_ch_genes
ANO2	lof_ch_genes
KDM2B	lof_ch_genes
P3H3	lof_ch_genes
PZP	lof_ch_genes
BEST3	lof_ch_genes
LRRIQ1	lof_ch_genes
SLCO1B1	lof_ch_genes
STAB2	lof_ch_genes
APPL2	lof_ch_genes
PIK3C2G	lof_ch_genes
LGR5	lof_ch_genes
SLC39A5	lof_ch_genes
CSAD	lof_ch_genes
CFAP251	lof_ch_genes
LRRC43	lof_ch_genes
OTOGL	lof_ch_genes
A2ML1	lof_ch_genes
MYO1A	lof_ch_genes
SOAT2	lof_ch_genes
CLEC12A	lof_ch_genes
ADAMTS20	lof_ch_genes
MYO1H	lof_ch_genes
ANO6	lof_ch_genes
CD163L1	lof_ch_genes
SLC17A8	lof_ch_genes
KNTC1	lof_ch_genes
FAM186A	lof_ch_genes
OVCH1	lof_ch_genes
CFAP54	lof_ch_genes
SLC15A5	lof_ch_genes
DNAH10	lof_ch_genes
CEP290	lof_ch_genes
ATXN2	lof_ch_genes
ACSM4	lof_ch_genes
KLRF2	lof_ch_genes
ATP12A	lof_ch_genes
VWA8	lof_ch_genes
MTRF1	lof_ch_genes
ATP7B	lof_ch_genes
TPTE2	lof_ch_genes
UPF3A	lof_ch_genes
SERPINE3	lof_ch_genes
RBM23	lof_ch_genes
NIN	lof_ch_genes
KIAA0586	lof_ch_genes
APEX1	lof_ch_genes
PCK2	lof_ch_genes
HEATR5A	lof_ch_genes
TEP1	lof_ch_genes
ABHD12B	lof_ch_genes
TTC6	lof_ch_genes
CBLN3	lof_ch_genes
TSSK4	lof_ch_genes
FAM161B	lof_ch_genes
TC2N	lof_ch_genes
IPO4	lof_ch_genes
OR11H12	lof_ch_genes
VPS13C	lof_ch_genes
UACA	lof_ch_genes
DUOX1	lof_ch_genes
STRA6	lof_ch_genes
SPTBN5	lof_ch_genes
SHF	lof_ch_genes
DUOX2	lof_ch_genes
UBE2Q2	lof_ch_genes
MAN2C1	lof_ch_genes
MCTP2	lof_ch_genes
MEGF11	lof_ch_genes
STARD9	lof_ch_genes
MESP1	lof_ch_genes
JMJD7-PLA2G4B	lof_ch_genes
MINAR1	lof_ch_genes
AKAP13	lof_ch_genes
STARD5	lof_ch_genes
IGDCC3	lof_ch_genes
SYNM	lof_ch_genes
GOLGA6B	lof_ch_genes
PLA2G4B	lof_ch_genes
NOX5	lof_ch_genes
BAIAP3	lof_ch_genes
MVP	lof_ch_genes
HSD17B2	lof_ch_genes
ABCC6	lof_ch_genes
PHKB	lof_ch_genes
MPG	lof_ch_genes
METTL26	lof_ch_genes
NOL3	lof_ch_genes
HIRIP3	lof_ch_genes
DNAH3	lof_ch_genes
SLC5A11	lof_ch_genes
LRRC36	lof_ch_genes
WDR90	lof_ch_genes
SLC38A8	lof_ch_genes
KCNG4	lof_ch_genes
PDILT	lof_ch_genes
PDIA2	lof_ch_genes
AC099489.1	lof_ch_genes
SPG7	lof_ch_genes
PKD1L3	lof_ch_genes
SARM1	lof_ch_genes
MYH13	lof_ch_genes
DNAH9	lof_ch_genes
HEATR6	lof_ch_genes
SMG6	lof_ch_genes
MYO15A	lof_ch_genes
UNC13D	lof_ch_genes
RECQL5	lof_ch_genes
CHRNE	lof_ch_genes
MYH1	lof_ch_genes
TEX14	lof_ch_genes
MYH2	lof_ch_genes
PLD2	lof_ch_genes
MYH8	lof_ch_genes
C17orf80	lof_ch_genes
SGSM2	lof_ch_genes
ABCA8	lof_ch_genes
ZMYND15	lof_ch_genes
SLC5A10	lof_ch_genes
ABCA10	lof_ch_genes
ABCA5	lof_ch_genes
PRPSAP1	lof_ch_genes
ACSF2	lof_ch_genes
CDK12	lof_ch_genes
SMG8	lof_ch_genes
RSKR	lof_ch_genes
EVPL	lof_ch_genes
CCDC144A	lof_ch_genes
ALOXE3	lof_ch_genes
RNF135	lof_ch_genes
NAA38	lof_ch_genes
ADAP2	lof_ch_genes
SMYD4	lof_ch_genes
KRT12	lof_ch_genes
DNAH17	lof_ch_genes
KIF19	lof_ch_genes
TRPV1	lof_ch_genes
KIAA0753	lof_ch_genes
TNFRSF13B	lof_ch_genes
AC005726.1	lof_ch_genes
MYH4	lof_ch_genes
HEATR9	lof_ch_genes
PIK3R6	lof_ch_genes
GGNBP2	lof_ch_genes
DSG2	lof_ch_genes
CTDP1	lof_ch_genes
MOCOS	lof_ch_genes
PIEZO2	lof_ch_genes
LOXHD1	lof_ch_genes
ANKRD30B	lof_ch_genes
ZSCAN30	lof_ch_genes
MRI1	lof_ch_genes
ABCA7	lof_ch_genes
PTPRH	lof_ch_genes
CERS4	lof_ch_genes
CATSPERG	lof_ch_genes
DHDH	lof_ch_genes
ECH1	lof_ch_genes
KLC3	lof_ch_genes
SYDE1	lof_ch_genes
SULT2A1	lof_ch_genes
KIR2DL1	lof_ch_genes
SH2D3A	lof_ch_genes
BCL2L12	lof_ch_genes
ADGRE2	lof_ch_genes
DOCK6	lof_ch_genes
TRPM4	lof_ch_genes
ANGPTL6	lof_ch_genes
NLRP12	lof_ch_genes
FBN3	lof_ch_genes
PWWP3A	lof_ch_genes
NPHS1	lof_ch_genes
PSG6	lof_ch_genes
ZNF440	lof_ch_genes
WDR87	lof_ch_genes
NLRP13	lof_ch_genes
FAM187B	lof_ch_genes
NLRP8	lof_ch_genes
MUC16	lof_ch_genes
RGS9BP	lof_ch_genes
NWD1	lof_ch_genes
ZNF181	lof_ch_genes
ZNF560	lof_ch_genes
ZNF667	lof_ch_genes
RGL3	lof_ch_genes
PSG1	lof_ch_genes
PSG4	lof_ch_genes
SIGLEC12	lof_ch_genes
AC011455.2	lof_ch_genes
FCGBP	lof_ch_genes
MYH7B	lof_ch_genes
FERMT1	lof_ch_genes
LPIN3	lof_ch_genes
ADAM33	lof_ch_genes
COL6A2	lof_ch_genes
TRPM2	lof_ch_genes
DOP1B	lof_ch_genes
TMPRSS15	lof_ch_genes
AIRE	lof_ch_genes
TSPEAR	lof_ch_genes
TRIOBP	lof_ch_genes
PARVG	lof_ch_genes
NDUFA6	lof_ch_genes
EFCAB6	lof_ch_genes
CCDC157	lof_ch_genes
XPNPEP3	lof_ch_genes
SFI1	lof_ch_genes
ARFGAP3	lof_ch_genes
NIPAL3	lof_possible_no_ch_genes
TTC22	lof_possible_no_ch_genes
CDK11A	lof_possible_no_ch_genes
MASP2	lof_possible_no_ch_genes
TRAF3IP3	lof_possible_no_ch_genes
CLCN6	lof_possible_no_ch_genes
CLCA4	lof_possible_no_ch_genes
ADSS2	lof_possible_no_ch_genes
USH2A	lof_possible_no_ch_genes
H6PD	lof_possible_no_ch_genes
CROCC	lof_possible_no_ch_genes
TARBP1	lof_possible_no_ch_genes
WDR3	lof_possible_no_ch_genes
SPEN	lof_possible_no_ch_genes
PACC1	lof_possible_no_ch_genes
EVI5	lof_possible_no_ch_genes
TGFBR3	lof_possible_no_ch_genes
PLXNA2	lof_possible_no_ch_genes
GPR137B	lof_possible_no_ch_genes
OVGP1	lof_possible_no_ch_genes
MUL1	lof_possible_no_ch_genes
BCL9	lof_possible_no_ch_genes
DNAJC16	lof_possible_no_ch_genes
LRRC42	lof_possible_no_ch_genes
NPHS2	lof_possible_no_ch_genes
STXBP3	lof_possible_no_ch_genes
ELAPOR1	lof_possible_no_ch_genes
HDAC1	lof_possible_no_ch_genes
ASH1L	lof_possible_no_ch_genes
DOCK7	lof_possible_no_ch_genes
PRG4	lof_possible_no_ch_genes
GADD45A	lof_possible_no_ch_genes
RO60	lof_possible_no_ch_genes
PLEKHM2	lof_possible_no_ch_genes
TTF2	lof_possible_no_ch_genes
NT5C1A	lof_possible_no_ch_genes
ST6GALNAC5	lof_possible_no_ch_genes
IGSF21	lof_possible_no_ch_genes
CDK18	lof_possible_no_ch_genes
PTCH2	lof_possible_no_ch_genes
AKR1A1	lof_possible_no_ch_genes
TMED5	lof_possible_no_ch_genes
PRRC2C	lof_possible_no_ch_genes
DARS2	lof_possible_no_ch_genes
RCOR3	lof_possible_no_ch_genes
ARID1A	lof_possible_no_ch_genes
ATF6	lof_possible_no_ch_genes
RAB3GAP2	lof_possible_no_ch_genes
TRIM67	lof_possible_no_ch_genes
HEATR1	lof_possible_no_ch_genes
ECHDC2	lof_possible_no_ch_genes
ADGRB2	lof_possible_no_ch_genes
LRIF1	lof_possible_no_ch_genes
AUNIP	lof_possible_no_ch_genes
HP1BP3	lof_possible_no_ch_genes
PPT1	lof_possible_no_ch_genes
NPHP4	lof_possible_no_ch_genes
CHD1L	lof_possible_no_ch_genes
FMO5	lof_possible_no_ch_genes
PRKAB2	lof_possible_no_ch_genes
SPATA6	lof_possible_no_ch_genes
ATP1A4	lof_possible_no_ch_genes
DPH2	lof_possible_no_ch_genes
MUTYH	lof_possible_no_ch_genes
GSTM3	lof_possible_no_ch_genes
CHIA	lof_possible_no_ch_genes
HMGCS2	lof_possible_no_ch_genes
PTGFRN	lof_possible_no_ch_genes
NOTCH2	lof_possible_no_ch_genes
NAV1	lof_possible_no_ch_genes
GNL2	lof_possible_no_ch_genes
HOOK1	lof_possible_no_ch_genes
PCNX2	lof_possible_no_ch_genes
NIBAN1	lof_possible_no_ch_genes
PIGC	lof_possible_no_ch_genes
LAMC1	lof_possible_no_ch_genes
TTLL7	lof_possible_no_ch_genes
BRDT	lof_possible_no_ch_genes
RABGGTB	lof_possible_no_ch_genes
SLC44A5	lof_possible_no_ch_genes
CLCA2	lof_possible_no_ch_genes
CNKSR1	lof_possible_no_ch_genes
EVA1B	lof_possible_no_ch_genes
HSPG2	lof_possible_no_ch_genes
CYP4B1	lof_possible_no_ch_genes
IGSF3	lof_possible_no_ch_genes
ITGA10	lof_possible_no_ch_genes
ALDH9A1	lof_possible_no_ch_genes
CASQ1	lof_possible_no_ch_genes
TOR1AIP1	lof_possible_no_ch_genes
ECM1	lof_possible_no_ch_genes
TAF1A	lof_possible_no_ch_genes
HHIPL2	lof_possible_no_ch_genes
SNAPIN	lof_possible_no_ch_genes
SLC39A1	lof_possible_no_ch_genes
INTS3	lof_possible_no_ch_genes
PKLR	lof_possible_no_ch_genes
C1orf131	lof_possible_no_ch_genes
GALNT2	lof_possible_no_ch_genes
MAP3K21	lof_possible_no_ch_genes
CNIH3	lof_possible_no_ch_genes
C1orf35	lof_possible_no_ch_genes
AHCTF1	lof_possible_no_ch_genes
SHCBP1L	lof_possible_no_ch_genes
C8A	lof_possible_no_ch_genes
SKI	lof_possible_no_ch_genes
PAFAH2	lof_possible_no_ch_genes
GRHL3	lof_possible_no_ch_genes
ELK4	lof_possible_no_ch_genes
SLC45A3	lof_possible_no_ch_genes
NBL1	lof_possible_no_ch_genes
VWA5B1	lof_possible_no_ch_genes
LAD1	lof_possible_no_ch_genes
CCDC17	lof_possible_no_ch_genes
IL6R	lof_possible_no_ch_genes
CYP4A22	lof_possible_no_ch_genes
CMPK1	lof_possible_no_ch_genes
HFM1	lof_possible_no_ch_genes
BROX	lof_possible_no_ch_genes
WDR64	lof_possible_no_ch_genes
KIF26B	lof_possible_no_ch_genes
FCMR	lof_possible_no_ch_genes
PIGR	lof_possible_no_ch_genes
CAPN2	lof_possible_no_ch_genes
VPS72	lof_possible_no_ch_genes
NAXE	lof_possible_no_ch_genes
MNDA	lof_possible_no_ch_genes
ZC3H12A	lof_possible_no_ch_genes
C1orf50	lof_possible_no_ch_genes
SERINC2	lof_possible_no_ch_genes
THBS3	lof_possible_no_ch_genes
EFNA1	lof_possible_no_ch_genes
METTL18	lof_possible_no_ch_genes
ANGPTL7	lof_possible_no_ch_genes
VANGL1	lof_possible_no_ch_genes
SH3BP5L	lof_possible_no_ch_genes
MTHFR	lof_possible_no_ch_genes
TMEM125	lof_possible_no_ch_genes
SELENOF	lof_possible_no_ch_genes
H3C13	lof_possible_no_ch_genes
C1QTNF12	lof_possible_no_ch_genes
TACSTD2	lof_possible_no_ch_genes
CLCNKB	lof_possible_no_ch_genes
SMYD3	lof_possible_no_ch_genes
AGBL4	lof_possible_no_ch_genes
CYP4Z1	lof_possible_no_ch_genes
CYP4X1	lof_possible_no_ch_genes
FOXD2	lof_possible_no_ch_genes
ESPN	lof_possible_no_ch_genes
FOXD3	lof_possible_no_ch_genes
KLHL17	lof_possible_no_ch_genes
RAB42	lof_possible_no_ch_genes
S100A4	lof_possible_no_ch_genes
SEMA4A	lof_possible_no_ch_genes
LAMB3	lof_possible_no_ch_genes
MIB2	lof_possible_no_ch_genes
HHLA3	lof_possible_no_ch_genes
EFCAB7	lof_possible_no_ch_genes
TMEM240	lof_possible_no_ch_genes
RBMXL1	lof_possible_no_ch_genes
NBPF1	lof_possible_no_ch_genes
ANKRD65	lof_possible_no_ch_genes
KIAA0040	lof_possible_no_ch_genes
BGLAP	lof_possible_no_ch_genes
PADI6	lof_possible_no_ch_genes
PRAMEF18	lof_possible_no_ch_genes
SLC11A1	lof_possible_no_ch_genes
RETSAT	lof_possible_no_ch_genes
CAPG	lof_possible_no_ch_genes
LY75	lof_possible_no_ch_genes
PUM2	lof_possible_no_ch_genes
PMS1	lof_possible_no_ch_genes
STON1-GTF2A1L	lof_possible_no_ch_genes
SRBD1	lof_possible_no_ch_genes
PTPN18	lof_possible_no_ch_genes
SPEG	lof_possible_no_ch_genes
ABCB11	lof_possible_no_ch_genes
CLASP1	lof_possible_no_ch_genes
DNAJC10	lof_possible_no_ch_genes
USP40	lof_possible_no_ch_genes
FAHD2A	lof_possible_no_ch_genes
GPD2	lof_possible_no_ch_genes
GALNT3	lof_possible_no_ch_genes
CCDC88A	lof_possible_no_ch_genes
FN1	lof_possible_no_ch_genes
PECR	lof_possible_no_ch_genes
IGFBP2	lof_possible_no_ch_genes
PLCD4	lof_possible_no_ch_genes
ABCB6	lof_possible_no_ch_genes
NOL10	lof_possible_no_ch_genes
GORASP2	lof_possible_no_ch_genes
CEBPZ	lof_possible_no_ch_genes
LCT	lof_possible_no_ch_genes
PLCL1	lof_possible_no_ch_genes
EPHA4	lof_possible_no_ch_genes
ECRG4	lof_possible_no_ch_genes
NCAPH	lof_possible_no_ch_genes
HJURP	lof_possible_no_ch_genes
TTC21B	lof_possible_no_ch_genes
VIL1	lof_possible_no_ch_genes
HOXD1	lof_possible_no_ch_genes
MTX2	lof_possible_no_ch_genes
PDE11A	lof_possible_no_ch_genes
HOXD13	lof_possible_no_ch_genes
PXDN	lof_possible_no_ch_genes
SAG	lof_possible_no_ch_genes
PER2	lof_possible_no_ch_genes
RAMP1	lof_possible_no_ch_genes
EGR4	lof_possible_no_ch_genes
DYSF	lof_possible_no_ch_genes
WNT10A	lof_possible_no_ch_genes
SMPD4	lof_possible_no_ch_genes
UGGT1	lof_possible_no_ch_genes
SELENOI	lof_possible_no_ch_genes
CYP1B1	lof_possible_no_ch_genes
TRIM54	lof_possible_no_ch_genes
ATIC	lof_possible_no_ch_genes
BARD1	lof_possible_no_ch_genes
NAB1	lof_possible_no_ch_genes
CDK15	lof_possible_no_ch_genes
MDH1B	lof_possible_no_ch_genes
ITPRID2	lof_possible_no_ch_genes
WDR12	lof_possible_no_ch_genes
ABI2	lof_possible_no_ch_genes
ITGAV	lof_possible_no_ch_genes
GDF7	lof_possible_no_ch_genes
CAMKMT	lof_possible_no_ch_genes
PKP4	lof_possible_no_ch_genes
PTH2R	lof_possible_no_ch_genes
NBEAL1	lof_possible_no_ch_genes
KANSL1L	lof_possible_no_ch_genes
NYAP2	lof_possible_no_ch_genes
ALLC	lof_possible_no_ch_genes
MFSD6	lof_possible_no_ch_genes
BOLL	lof_possible_no_ch_genes
RASGRP3	lof_possible_no_ch_genes
ANAPC1	lof_possible_no_ch_genes
RGPD3	lof_possible_no_ch_genes
ATP5MC3	lof_possible_no_ch_genes
CNTNAP5	lof_possible_no_ch_genes
EIF5B	lof_possible_no_ch_genes
PKDCC	lof_possible_no_ch_genes
TYW5	lof_possible_no_ch_genes
SLC16A14	lof_possible_no_ch_genes
ARHGAP25	lof_possible_no_ch_genes
TMEM169	lof_possible_no_ch_genes
GLB1L	lof_possible_no_ch_genes
ICA1L	lof_possible_no_ch_genes
KIF5C	lof_possible_no_ch_genes
E2F6	lof_possible_no_ch_genes
SCN9A	lof_possible_no_ch_genes
APLF	lof_possible_no_ch_genes
BUB1	lof_possible_no_ch_genes
LIMS1	lof_possible_no_ch_genes
HOXD12	lof_possible_no_ch_genes
FAM161A	lof_possible_no_ch_genes
FEZ2	lof_possible_no_ch_genes
ALK	lof_possible_no_ch_genes
ECEL1	lof_possible_no_ch_genes
REG1B	lof_possible_no_ch_genes
KLF11	lof_possible_no_ch_genes
UBXN2A	lof_possible_no_ch_genes
NCKAP5	lof_possible_no_ch_genes
RBM44	lof_possible_no_ch_genes
PLEKHM3	lof_possible_no_ch_genes
FOXD4L1	lof_possible_no_ch_genes
FAM110C	lof_possible_no_ch_genes
SEPTIN10	lof_possible_no_ch_genes
SESTD1	lof_possible_no_ch_genes
CERKL	lof_possible_no_ch_genes
SLC4A5	lof_possible_no_ch_genes
RFX8	lof_possible_no_ch_genes
TTC30B	lof_possible_no_ch_genes
RGPD4	lof_possible_no_ch_genes
SULT1C2	lof_possible_no_ch_genes
SPRED2	lof_possible_no_ch_genes
TBC1D8	lof_possible_no_ch_genes
CDKL4	lof_possible_no_ch_genes
SP9	lof_possible_no_ch_genes
DYTN	lof_possible_no_ch_genes
STPG4	lof_possible_no_ch_genes
STON1	lof_possible_no_ch_genes
LY75-CD302	lof_possible_no_ch_genes
PPP4R3B	lof_possible_no_ch_genes
RBM5	lof_possible_no_ch_genes
CELSR3	lof_possible_no_ch_genes
LTF	lof_possible_no_ch_genes
SLC4A7	lof_possible_no_ch_genes
ASTE1	lof_possible_no_ch_genes
DCBLD2	lof_possible_no_ch_genes
TNK2	lof_possible_no_ch_genes
PPP2R3A	lof_possible_no_ch_genes
ST6GAL1	lof_possible_no_ch_genes
LXN	lof_possible_no_ch_genes
KIF9	lof_possible_no_ch_genes
CDV3	lof_possible_no_ch_genes
OGG1	lof_possible_no_ch_genes
CEP70	lof_possible_no_ch_genes
GRK7	lof_possible_no_ch_genes
XRN1	lof_possible_no_ch_genes
SERPINI2	lof_possible_no_ch_genes
COL7A1	lof_possible_no_ch_genes
GNB4	lof_possible_no_ch_genes
FRMD4B	lof_possible_no_ch_genes
CISH	lof_possible_no_ch_genes
EIF4G1	lof_possible_no_ch_genes
PDZRN3	lof_possible_no_ch_genes
SEC22A	lof_possible_no_ch_genes
TNFSF10	lof_possible_no_ch_genes
ATP13A4	lof_possible_no_ch_genes
MBD4	lof_possible_no_ch_genes
RBSN	lof_possible_no_ch_genes
SLC25A26	lof_possible_no_ch_genes
NXPE3	lof_possible_no_ch_genes
BOC	lof_possible_no_ch_genes
TMEM44	lof_possible_no_ch_genes
ECE2	lof_possible_no_ch_genes
NGLY1	lof_possible_no_ch_genes
QTRT2	lof_possible_no_ch_genes
KLHL40	lof_possible_no_ch_genes
DZIP1L	lof_possible_no_ch_genes
ESYT3	lof_possible_no_ch_genes
FAIM	lof_possible_no_ch_genes
MYL3	lof_possible_no_ch_genes
FBLN2	lof_possible_no_ch_genes
CLASP2	lof_possible_no_ch_genes
CD200R1	lof_possible_no_ch_genes
SPICE1	lof_possible_no_ch_genes
ATXN7	lof_possible_no_ch_genes
PRICKLE2	lof_possible_no_ch_genes
PTX3	lof_possible_no_ch_genes
IL17RE	lof_possible_no_ch_genes
PRRT3	lof_possible_no_ch_genes
GYG1	lof_possible_no_ch_genes
HPS3	lof_possible_no_ch_genes
RYK	lof_possible_no_ch_genes
KIF15	lof_possible_no_ch_genes
FYCO1	lof_possible_no_ch_genes
DTX3L	lof_possible_no_ch_genes
YEATS2	lof_possible_no_ch_genes
IFT122	lof_possible_no_ch_genes
TKT	lof_possible_no_ch_genes
TASOR	lof_possible_no_ch_genes
SLC51A	lof_possible_no_ch_genes
PLXNB1	lof_possible_no_ch_genes
ATRIP	lof_possible_no_ch_genes
TRANK1	lof_possible_no_ch_genes
ZBBX	lof_possible_no_ch_genes
HSPBAP1	lof_possible_no_ch_genes
BTD	lof_possible_no_ch_genes
SUCLG2	lof_possible_no_ch_genes
PARP15	lof_possible_no_ch_genes
SLCO2A1	lof_possible_no_ch_genes
RSRC1	lof_possible_no_ch_genes
DHX36	lof_possible_no_ch_genes
ZIC4	lof_possible_no_ch_genes
ZNF654	lof_possible_no_ch_genes
USF3	lof_possible_no_ch_genes
B3GNT5	lof_possible_no_ch_genes
ALS2CL	lof_possible_no_ch_genes
GRAMD1C	lof_possible_no_ch_genes
C3orf38	lof_possible_no_ch_genes
HCLS1	lof_possible_no_ch_genes
CCDC66	lof_possible_no_ch_genes
HMCES	lof_possible_no_ch_genes
TRAIP	lof_possible_no_ch_genes
TPRG1	lof_possible_no_ch_genes
OSTN	lof_possible_no_ch_genes
ZKSCAN7	lof_possible_no_ch_genes
PIK3R4	lof_possible_no_ch_genes
CD200R1L	lof_possible_no_ch_genes
TREX1	lof_possible_no_ch_genes
SPINK8	lof_possible_no_ch_genes
GPX1	lof_possible_no_ch_genes
CCDC13	lof_possible_no_ch_genes
TMEM158	lof_possible_no_ch_genes
AC006059.2	lof_possible_no_ch_genes
CCDC39	lof_possible_no_ch_genes
EEF1AKMT4-ECE2	lof_possible_no_ch_genes
LAP3	lof_possible_no_ch_genes
RUFY3	lof_possible_no_ch_genes
UBA6	lof_possible_no_ch_genes
CC2D2A	lof_possible_no_ch_genes
FNIP2	lof_possible_no_ch_genes
TXK	lof_possible_no_ch_genes
N4BP2	lof_possible_no_ch_genes
CRACD	lof_possible_no_ch_genes
NFKB1	lof_possible_no_ch_genes
AREG	lof_possible_no_ch_genes
ELF2	lof_possible_no_ch_genes
SEPSECS	lof_possible_no_ch_genes
SLC2A9	lof_possible_no_ch_genes
MFSD10	lof_possible_no_ch_genes
BST1	lof_possible_no_ch_genes
SPP1	lof_possible_no_ch_genes
PAICS	lof_possible_no_ch_genes
POLN	lof_possible_no_ch_genes
KLB	lof_possible_no_ch_genes
UGT2B28	lof_possible_no_ch_genes
TTC29	lof_possible_no_ch_genes
DDX60	lof_possible_no_ch_genes
HERC6	lof_possible_no_ch_genes
HERC5	lof_possible_no_ch_genes
ZGRF1	lof_possible_no_ch_genes
KIAA1109	lof_possible_no_ch_genes
MMRN1	lof_possible_no_ch_genes
PDE5A	lof_possible_no_ch_genes
TRPC3	lof_possible_no_ch_genes
FRAS1	lof_possible_no_ch_genes
PPA2	lof_possible_no_ch_genes
PYURF	lof_possible_no_ch_genes
RNF175	lof_possible_no_ch_genes
MMAA	lof_possible_no_ch_genes
DMP1	lof_possible_no_ch_genes
ADGRA3	lof_possible_no_ch_genes
UGT2B4	lof_possible_no_ch_genes
AASDH	lof_possible_no_ch_genes
SPON2	lof_possible_no_ch_genes
HPGDS	lof_possible_no_ch_genes
GNPDA2	lof_possible_no_ch_genes
C4orf36	lof_possible_no_ch_genes
AIMP1	lof_possible_no_ch_genes
INTU	lof_possible_no_ch_genes
C4orf3	lof_possible_no_ch_genes
MAP9	lof_possible_no_ch_genes
OTUD4	lof_possible_no_ch_genes
ZCCHC4	lof_possible_no_ch_genes
NPNT	lof_possible_no_ch_genes
TET2	lof_possible_no_ch_genes
ZBTB49	lof_possible_no_ch_genes
SLC49A3	lof_possible_no_ch_genes
USP38	lof_possible_no_ch_genes
NFXL1	lof_possible_no_ch_genes
NUDT6	lof_possible_no_ch_genes
LARP7	lof_possible_no_ch_genes
SRP72	lof_possible_no_ch_genes
ODAPH	lof_possible_no_ch_genes
BTC	lof_possible_no_ch_genes
CCSER1	lof_possible_no_ch_genes
NPY2R	lof_possible_no_ch_genes
DEFB131A	lof_possible_no_ch_genes
SOWAHB	lof_possible_no_ch_genes
QRFPR	lof_possible_no_ch_genes
ADH7	lof_possible_no_ch_genes
UGT2B15	lof_possible_no_ch_genes
TMPRSS11F	lof_possible_no_ch_genes
C4orf46	lof_possible_no_ch_genes
CFI	lof_possible_no_ch_genes
ARHGEF38	lof_possible_no_ch_genes
AC126283.2	lof_possible_no_ch_genes
FLT4	lof_possible_no_ch_genes
DNAH5	lof_possible_no_ch_genes
SOX30	lof_possible_no_ch_genes
JADE2	lof_possible_no_ch_genes
COL23A1	lof_possible_no_ch_genes
PRDM6	lof_possible_no_ch_genes
TCOF1	lof_possible_no_ch_genes
P4HA2	lof_possible_no_ch_genes
GEMIN5	lof_possible_no_ch_genes
SEMA6A	lof_possible_no_ch_genes
CEP72	lof_possible_no_ch_genes
C7	lof_possible_no_ch_genes
GHR	lof_possible_no_ch_genes
MRPS30	lof_possible_no_ch_genes
MRPS27	lof_possible_no_ch_genes
APBB3	lof_possible_no_ch_genes
BTNL8	lof_possible_no_ch_genes
RAD50	lof_possible_no_ch_genes
PPWD1	lof_possible_no_ch_genes
C9	lof_possible_no_ch_genes
MYOT	lof_possible_no_ch_genes
FASTKD3	lof_possible_no_ch_genes
EPB41L4A	lof_possible_no_ch_genes
BHMT2	lof_possible_no_ch_genes
HSD17B4	lof_possible_no_ch_genes
CCNB1	lof_possible_no_ch_genes
IL6ST	lof_possible_no_ch_genes
OSMR	lof_possible_no_ch_genes
PPIP5K2	lof_possible_no_ch_genes
BDP1	lof_possible_no_ch_genes
TSLP	lof_possible_no_ch_genes
FEM1C	lof_possible_no_ch_genes
CXCL14	lof_possible_no_ch_genes
DDX46	lof_possible_no_ch_genes
RNF44	lof_possible_no_ch_genes
PARP8	lof_possible_no_ch_genes
CDH12	lof_possible_no_ch_genes
GRAMD2B	lof_possible_no_ch_genes
SLC26A2	lof_possible_no_ch_genes
LSM11	lof_possible_no_ch_genes
MGAT4B	lof_possible_no_ch_genes
ELOVL7	lof_possible_no_ch_genes
RANBP3L	lof_possible_no_ch_genes
AGGF1	lof_possible_no_ch_genes
SCGB3A2	lof_possible_no_ch_genes
CMYA5	lof_possible_no_ch_genes
NSA2	lof_possible_no_ch_genes
SLC6A18	lof_possible_no_ch_genes
IL31RA	lof_possible_no_ch_genes
ANKRD55	lof_possible_no_ch_genes
NSD1	lof_possible_no_ch_genes
ACTBL2	lof_possible_no_ch_genes
RGS14	lof_possible_no_ch_genes
HARS1	lof_possible_no_ch_genes
EMB	lof_possible_no_ch_genes
C5orf34	lof_possible_no_ch_genes
ZNF131	lof_possible_no_ch_genes
DMXL1	lof_possible_no_ch_genes
SLC6A19	lof_possible_no_ch_genes
GPR150	lof_possible_no_ch_genes
FAM153B	lof_possible_no_ch_genes
RXFP3	lof_possible_no_ch_genes
PLCXD3	lof_possible_no_ch_genes
DDX41	lof_possible_no_ch_genes
SLC36A2	lof_possible_no_ch_genes
RGS7BP	lof_possible_no_ch_genes
TMEM232	lof_possible_no_ch_genes
TBC1D9B	lof_possible_no_ch_genes
FAM169A	lof_possible_no_ch_genes
PCDHA7	lof_possible_no_ch_genes
PCDHA5	lof_possible_no_ch_genes
SLCO6A1	lof_possible_no_ch_genes
ARHGEF28	lof_possible_no_ch_genes
PCDHGC5	lof_possible_no_ch_genes
EIF4EBP3	lof_possible_no_ch_genes
PCDHGB6	lof_possible_no_ch_genes
PCDHGA8	lof_possible_no_ch_genes
PCDHGB7	lof_possible_no_ch_genes
ANKHD1-EIF4EBP3	lof_possible_no_ch_genes
PCDHGA4	lof_possible_no_ch_genes
PCDHGB5	lof_possible_no_ch_genes
AC116366.2	lof_possible_no_ch_genes
TFAP2D	lof_possible_no_ch_genes
REV3L	lof_possible_no_ch_genes
PGM3	lof_possible_no_ch_genes
DEF6	lof_possible_no_ch_genes
UBR2	lof_possible_no_ch_genes
UHRF1BP1	lof_possible_no_ch_genes
EPB41L2	lof_possible_no_ch_genes
OSTM1	lof_possible_no_ch_genes
SRPK1	lof_possible_no_ch_genes
EFHC1	lof_possible_no_ch_genes
ITPR3	lof_possible_no_ch_genes
DSP	lof_possible_no_ch_genes
CEP85L	lof_possible_no_ch_genes
MCM9	lof_possible_no_ch_genes
GABRR2	lof_possible_no_ch_genes
BAG2	lof_possible_no_ch_genes
RAB23	lof_possible_no_ch_genes
ASCC3	lof_possible_no_ch_genes
BVES	lof_possible_no_ch_genes
MED23	lof_possible_no_ch_genes
ACOT13	lof_possible_no_ch_genes
SLC17A2	lof_possible_no_ch_genes
UNC93A	lof_possible_no_ch_genes
SLC22A2	lof_possible_no_ch_genes
CCND3	lof_possible_no_ch_genes
PRPH2	lof_possible_no_ch_genes
CUL9	lof_possible_no_ch_genes
SENP6	lof_possible_no_ch_genes
VEGFA	lof_possible_no_ch_genes
CCN6	lof_possible_no_ch_genes
ENPP5	lof_possible_no_ch_genes
PRSS16	lof_possible_no_ch_genes
TBX18	lof_possible_no_ch_genes
ADGB	lof_possible_no_ch_genes
AKAP7	lof_possible_no_ch_genes
PLEKHG1	lof_possible_no_ch_genes
ABCC10	lof_possible_no_ch_genes
UNC5CL	lof_possible_no_ch_genes
KLHDC3	lof_possible_no_ch_genes
TREM1	lof_possible_no_ch_genes
MEA1	lof_possible_no_ch_genes
RIOK1	lof_possible_no_ch_genes
DEK	lof_possible_no_ch_genes
ERMARD	lof_possible_no_ch_genes
ULBP3	lof_possible_no_ch_genes
CEP162	lof_possible_no_ch_genes
LTV1	lof_possible_no_ch_genes
NMBR	lof_possible_no_ch_genes
FOXF2	lof_possible_no_ch_genes
FAM8A1	lof_possible_no_ch_genes
SLC17A4	lof_possible_no_ch_genes
TCTE1	lof_possible_no_ch_genes
TPBG	lof_possible_no_ch_genes
TBC1D32	lof_possible_no_ch_genes
RNF217	lof_possible_no_ch_genes
MTFR2	lof_possible_no_ch_genes
PNLDC1	lof_possible_no_ch_genes
VIP	lof_possible_no_ch_genes
SLC22A3	lof_possible_no_ch_genes
UTRN	lof_possible_no_ch_genes
RAET1L	lof_possible_no_ch_genes
ZSCAN12	lof_possible_no_ch_genes
SLC35A1	lof_possible_no_ch_genes
TMEM200A	lof_possible_no_ch_genes
FAM83B	lof_possible_no_ch_genes
POLH	lof_possible_no_ch_genes
THEMIS	lof_possible_no_ch_genes
ZC3H12D	lof_possible_no_ch_genes
TMEM151B	lof_possible_no_ch_genes
POU3F2	lof_possible_no_ch_genes
RFX6	lof_possible_no_ch_genes
TREML4	lof_possible_no_ch_genes
EYS	lof_possible_no_ch_genes
ZNF292	lof_possible_no_ch_genes
ZKSCAN3	lof_possible_no_ch_genes
L3MBTL3	lof_possible_no_ch_genes
DAXX	lof_possible_no_ch_genes
HSD17B8	lof_possible_no_ch_genes
BTNL2	lof_possible_no_ch_genes
NOTCH4	lof_possible_no_ch_genes
SKIV2L	lof_possible_no_ch_genes
SLC44A4	lof_possible_no_ch_genes
LSM2	lof_possible_no_ch_genes
MSH5	lof_possible_no_ch_genes
MPIG6B	lof_possible_no_ch_genes
LY6G6F	lof_possible_no_ch_genes
MICA	lof_possible_no_ch_genes
DHX16	lof_possible_no_ch_genes
TAAR9	lof_possible_no_ch_genes
CFB	lof_possible_no_ch_genes
AL645922.1	lof_possible_no_ch_genes
LY6G6D	lof_possible_no_ch_genes
ERVFRD-1	lof_possible_no_ch_genes
LY6G6F-LY6G6D	lof_possible_no_ch_genes
MUC22	lof_possible_no_ch_genes
RPS10-NUDT3	lof_possible_no_ch_genes
NUDT3	lof_possible_no_ch_genes
KDM7A	lof_possible_no_ch_genes
PHTF2	lof_possible_no_ch_genes
SCIN	lof_possible_no_ch_genes
NUB1	lof_possible_no_ch_genes
NPC1L1	lof_possible_no_ch_genes
TBXAS1	lof_possible_no_ch_genes
PARP12	lof_possible_no_ch_genes
SEMA3C	lof_possible_no_ch_genes
LRCH4	lof_possible_no_ch_genes
ZCWPW1	lof_possible_no_ch_genes
ADCYAP1R1	lof_possible_no_ch_genes
LAMB4	lof_possible_no_ch_genes
DLD	lof_possible_no_ch_genes
STEAP1B	lof_possible_no_ch_genes
HOXA6	lof_possible_no_ch_genes
COBL	lof_possible_no_ch_genes
PLEKHA8	lof_possible_no_ch_genes
EPHB6	lof_possible_no_ch_genes
EIF3B	lof_possible_no_ch_genes
MEOX2	lof_possible_no_ch_genes
POU6F2	lof_possible_no_ch_genes
AEBP1	lof_possible_no_ch_genes
PMS2	lof_possible_no_ch_genes
FKBP9	lof_possible_no_ch_genes
KIAA1549	lof_possible_no_ch_genes
LRRC61	lof_possible_no_ch_genes
CDHR3	lof_possible_no_ch_genes
FOXP2	lof_possible_no_ch_genes
IFT22	lof_possible_no_ch_genes
IRF5	lof_possible_no_ch_genes
SUMF2	lof_possible_no_ch_genes
DPP6	lof_possible_no_ch_genes
ARPC1B	lof_possible_no_ch_genes
KRBA1	lof_possible_no_ch_genes
DMTF1	lof_possible_no_ch_genes
CCDC146	lof_possible_no_ch_genes
C7orf25	lof_possible_no_ch_genes
NUP42	lof_possible_no_ch_genes
AOAH	lof_possible_no_ch_genes
TBRG4	lof_possible_no_ch_genes
HUS1	lof_possible_no_ch_genes
NACAD	lof_possible_no_ch_genes
IGFBP3	lof_possible_no_ch_genes
EPHA1	lof_possible_no_ch_genes
NOM1	lof_possible_no_ch_genes
NUP205	lof_possible_no_ch_genes
SLC37A3	lof_possible_no_ch_genes
TSPAN33	lof_possible_no_ch_genes
CPA5	lof_possible_no_ch_genes
FAM131B	lof_possible_no_ch_genes
PPP1R35	lof_possible_no_ch_genes
STK17A	lof_possible_no_ch_genes
COG5	lof_possible_no_ch_genes
NEUROD6	lof_possible_no_ch_genes
STEAP1	lof_possible_no_ch_genes
DNAAF5	lof_possible_no_ch_genes
MPLKIP	lof_possible_no_ch_genes
TMEM196	lof_possible_no_ch_genes
DNAJC30	lof_possible_no_ch_genes
ITPRID1	lof_possible_no_ch_genes
UPP1	lof_possible_no_ch_genes
MACC1	lof_possible_no_ch_genes
IKZF1	lof_possible_no_ch_genes
PCLO	lof_possible_no_ch_genes
TRRAP	lof_possible_no_ch_genes
ZNF138	lof_possible_no_ch_genes
HOXA4	lof_possible_no_ch_genes
ZNF277	lof_possible_no_ch_genes
TYW1	lof_possible_no_ch_genes
SLC35B4	lof_possible_no_ch_genes
GPC2	lof_possible_no_ch_genes
FAM133B	lof_possible_no_ch_genes
AC004922.1	lof_possible_no_ch_genes
ANK1	lof_possible_no_ch_genes
NSMAF	lof_possible_no_ch_genes
MSR1	lof_possible_no_ch_genes
TAF2	lof_possible_no_ch_genes
ZFAT	lof_possible_no_ch_genes
CPSF1	lof_possible_no_ch_genes
ZFHX4	lof_possible_no_ch_genes
ZDHHC2	lof_possible_no_ch_genes
STK3	lof_possible_no_ch_genes
R3HCC1	lof_possible_no_ch_genes
ARHGEF10	lof_possible_no_ch_genes
CLU	lof_possible_no_ch_genes
MTUS1	lof_possible_no_ch_genes
TTI2	lof_possible_no_ch_genes
VPS13B	lof_possible_no_ch_genes
E2F5	lof_possible_no_ch_genes
RNF122	lof_possible_no_ch_genes
SULF1	lof_possible_no_ch_genes
MFHAS1	lof_possible_no_ch_genes
TRIM55	lof_possible_no_ch_genes
TATDN1	lof_possible_no_ch_genes
FAM83A	lof_possible_no_ch_genes
RAB11FIP1	lof_possible_no_ch_genes
UNC5D	lof_possible_no_ch_genes
FAM160B2	lof_possible_no_ch_genes
HEY1	lof_possible_no_ch_genes
SLC30A8	lof_possible_no_ch_genes
CSMD3	lof_possible_no_ch_genes
SPIDR	lof_possible_no_ch_genes
GEM	lof_possible_no_ch_genes
TMEM67	lof_possible_no_ch_genes
SCARA3	lof_possible_no_ch_genes
HTRA4	lof_possible_no_ch_genes
ESCO2	lof_possible_no_ch_genes
ADCK5	lof_possible_no_ch_genes
FAM91A1	lof_possible_no_ch_genes
MCMDC2	lof_possible_no_ch_genes
OPLAH	lof_possible_no_ch_genes
KCNB2	lof_possible_no_ch_genes
POMK	lof_possible_no_ch_genes
ENTPD4	lof_possible_no_ch_genes
CNOT7	lof_possible_no_ch_genes
FBXO16	lof_possible_no_ch_genes
MROH5	lof_possible_no_ch_genes
PRKDC	lof_possible_no_ch_genes
LRRC24	lof_possible_no_ch_genes
C8orf89	lof_possible_no_ch_genes
MUSK	lof_possible_no_ch_genes
CNTLN	lof_possible_no_ch_genes
FRMPD1	lof_possible_no_ch_genes
GBA2	lof_possible_no_ch_genes
SMARCA2	lof_possible_no_ch_genes
PUM3	lof_possible_no_ch_genes
TBC1D2	lof_possible_no_ch_genes
PTGR1	lof_possible_no_ch_genes
AMBP	lof_possible_no_ch_genes
DOCK8	lof_possible_no_ch_genes
LHX3	lof_possible_no_ch_genes
GLIS3	lof_possible_no_ch_genes
SETX	lof_possible_no_ch_genes
EXOSC3	lof_possible_no_ch_genes
TRPM6	lof_possible_no_ch_genes
TJP2	lof_possible_no_ch_genes
FBXW2	lof_possible_no_ch_genes
GALNT12	lof_possible_no_ch_genes
MLANA	lof_possible_no_ch_genes
MRPS2	lof_possible_no_ch_genes
CKS2	lof_possible_no_ch_genes
TTF1	lof_possible_no_ch_genes
OMD	lof_possible_no_ch_genes
PRDM12	lof_possible_no_ch_genes
PRRC2B	lof_possible_no_ch_genes
HABP4	lof_possible_no_ch_genes
CDK9	lof_possible_no_ch_genes
ODF2	lof_possible_no_ch_genes
ECPAS	lof_possible_no_ch_genes
SMC2	lof_possible_no_ch_genes
CDK5RAP2	lof_possible_no_ch_genes
USP20	lof_possible_no_ch_genes
DMAC1	lof_possible_no_ch_genes
CCL21	lof_possible_no_ch_genes
CD72	lof_possible_no_ch_genes
IGFBPL1	lof_possible_no_ch_genes
DENND4C	lof_possible_no_ch_genes
IFNK	lof_possible_no_ch_genes
CEP78	lof_possible_no_ch_genes
GSN	lof_possible_no_ch_genes
MRRF	lof_possible_no_ch_genes
CRB2	lof_possible_no_ch_genes
POLE3	lof_possible_no_ch_genes
CIZ1	lof_possible_no_ch_genes
C9orf85	lof_possible_no_ch_genes
FANCC	lof_possible_no_ch_genes
FBXW5	lof_possible_no_ch_genes
SNAPC3	lof_possible_no_ch_genes
FXN	lof_possible_no_ch_genes
KIF27	lof_possible_no_ch_genes
SHOC1	lof_possible_no_ch_genes
ZNF367	lof_possible_no_ch_genes
TRMT10B	lof_possible_no_ch_genes
NSMF	lof_possible_no_ch_genes
SLC27A4	lof_possible_no_ch_genes
ABO	lof_possible_no_ch_genes
ZDHHC21	lof_possible_no_ch_genes
GRIN1	lof_possible_no_ch_genes
C8G	lof_possible_no_ch_genes
MAN1B1	lof_possible_no_ch_genes
LCN15	lof_possible_no_ch_genes
ADAMTSL1	lof_possible_no_ch_genes
C9orf50	lof_possible_no_ch_genes
ANKRD18A	lof_possible_no_ch_genes
EHMT1	lof_possible_no_ch_genes
LRRC26	lof_possible_no_ch_genes
NUTM2G	lof_possible_no_ch_genes
VPS13A	lof_possible_no_ch_genes
TPM2	lof_possible_no_ch_genes
STKLD1	lof_possible_no_ch_genes
OR13C3	lof_possible_no_ch_genes
FAM205A	lof_possible_no_ch_genes
ORM1	lof_possible_no_ch_genes
ANKRD18B	lof_possible_no_ch_genes
AL358113.1	lof_possible_no_ch_genes
ALOX5	lof_possible_no_ch_genes
AIFM2	lof_possible_no_ch_genes
COL17A1	lof_possible_no_ch_genes
SEC61A2	lof_possible_no_ch_genes
PFKP	lof_possible_no_ch_genes
RHOBTB1	lof_possible_no_ch_genes
MYO3A	lof_possible_no_ch_genes
PDLIM1	lof_possible_no_ch_genes
PALD1	lof_possible_no_ch_genes
LZTS2	lof_possible_no_ch_genes
NPM3	lof_possible_no_ch_genes
GBF1	lof_possible_no_ch_genes
ANKRD26	lof_possible_no_ch_genes
NEURL1	lof_possible_no_ch_genes
PPIF	lof_possible_no_ch_genes
SFRP5	lof_possible_no_ch_genes
ANXA11	lof_possible_no_ch_genes
LDB3	lof_possible_no_ch_genes
PRXL2A	lof_possible_no_ch_genes
PLAU	lof_possible_no_ch_genes
SLC25A16	lof_possible_no_ch_genes
ECHS1	lof_possible_no_ch_genes
TUBGCP2	lof_possible_no_ch_genes
DNAJC1	lof_possible_no_ch_genes
MFSD13A	lof_possible_no_ch_genes
TACC2	lof_possible_no_ch_genes
ARL3	lof_possible_no_ch_genes
EXOC6	lof_possible_no_ch_genes
ADAMTS14	lof_possible_no_ch_genes
COMMD3	lof_possible_no_ch_genes
ANKRD30A	lof_possible_no_ch_genes
ZEB1	lof_possible_no_ch_genes
MPP7	lof_possible_no_ch_genes
PCDH15	lof_possible_no_ch_genes
DOCK1	lof_possible_no_ch_genes
CDC123	lof_possible_no_ch_genes
MARVELD1	lof_possible_no_ch_genes
PIK3AP1	lof_possible_no_ch_genes
TYSND1	lof_possible_no_ch_genes
BMS1	lof_possible_no_ch_genes
VWA2	lof_possible_no_ch_genes
UBTD1	lof_possible_no_ch_genes
HTRA1	lof_possible_no_ch_genes
PCBD1	lof_possible_no_ch_genes
WBP1L	lof_possible_no_ch_genes
AFAP1L2	lof_possible_no_ch_genes
HNRNPF	lof_possible_no_ch_genes
FAM241B	lof_possible_no_ch_genes
JMJD1C	lof_possible_no_ch_genes
WASHC2C	lof_possible_no_ch_genes
ZFAND4	lof_possible_no_ch_genes
SNCG	lof_possible_no_ch_genes
FZD8	lof_possible_no_ch_genes
SKIDA1	lof_possible_no_ch_genes
PPA1	lof_possible_no_ch_genes
RTKN2	lof_possible_no_ch_genes
THNSL1	lof_possible_no_ch_genes
DMBT1	lof_possible_no_ch_genes
FAM53B	lof_possible_no_ch_genes
PSAP	lof_possible_no_ch_genes
NRAP	lof_possible_no_ch_genes
ZNF511	lof_possible_no_ch_genes
PAPSS2	lof_possible_no_ch_genes
LDB1	lof_possible_no_ch_genes
LIPN	lof_possible_no_ch_genes
LIPJ	lof_possible_no_ch_genes
DNAJC9	lof_possible_no_ch_genes
CCDC7	lof_possible_no_ch_genes
HOGA1	lof_possible_no_ch_genes
ZNF511-PRAP1	lof_possible_no_ch_genes
POLA2	lof_possible_no_ch_genes
QSER1	lof_possible_no_ch_genes
PYGM	lof_possible_no_ch_genes
TRPM5	lof_possible_no_ch_genes
NXPE1	lof_possible_no_ch_genes
SNX15	lof_possible_no_ch_genes
ATG2A	lof_possible_no_ch_genes
DCPS	lof_possible_no_ch_genes
NRXN2	lof_possible_no_ch_genes
KIAA1549L	lof_possible_no_ch_genes
ACCS	lof_possible_no_ch_genes
HPS5	lof_possible_no_ch_genes
POU2AF1	lof_possible_no_ch_genes
TRIM6	lof_possible_no_ch_genes
KBTBD4	lof_possible_no_ch_genes
FRMD8	lof_possible_no_ch_genes
LSP1	lof_possible_no_ch_genes
PPFIA1	lof_possible_no_ch_genes
CNGA4	lof_possible_no_ch_genes
ACY3	lof_possible_no_ch_genes
TESMIN	lof_possible_no_ch_genes
LGALS12	lof_possible_no_ch_genes
SWAP70	lof_possible_no_ch_genes
ANO3	lof_possible_no_ch_genes
NAT10	lof_possible_no_ch_genes
RNF121	lof_possible_no_ch_genes
SORL1	lof_possible_no_ch_genes
BTG4	lof_possible_no_ch_genes
TMPRSS13	lof_possible_no_ch_genes
PGGHG	lof_possible_no_ch_genes
PAMR1	lof_possible_no_ch_genes
DGKZ	lof_possible_no_ch_genes
EIF3M	lof_possible_no_ch_genes
TENM4	lof_possible_no_ch_genes
INTS4	lof_possible_no_ch_genes
ZC3H12C	lof_possible_no_ch_genes
HTR3B	lof_possible_no_ch_genes
ATM	lof_possible_no_ch_genes
TKFC	lof_possible_no_ch_genes
FADS1	lof_possible_no_ch_genes
ROM1	lof_possible_no_ch_genes
MPZL2	lof_possible_no_ch_genes
TMEM25	lof_possible_no_ch_genes
MMP3	lof_possible_no_ch_genes
DLG2	lof_possible_no_ch_genes
DIXDC1	lof_possible_no_ch_genes
EXT2	lof_possible_no_ch_genes
GDPD5	lof_possible_no_ch_genes
SIK3	lof_possible_no_ch_genes
VPS11	lof_possible_no_ch_genes
INPPL1	lof_possible_no_ch_genes
CEP295	lof_possible_no_ch_genes
ADAMTS15	lof_possible_no_ch_genes
PATL1	lof_possible_no_ch_genes
RNF214	lof_possible_no_ch_genes
SAC3D1	lof_possible_no_ch_genes
SF1	lof_possible_no_ch_genes
NFRKB	lof_possible_no_ch_genes
CDC42BPG	lof_possible_no_ch_genes
C2CD2L	lof_possible_no_ch_genes
OR5T3	lof_possible_no_ch_genes
CTSW	lof_possible_no_ch_genes
GRK2	lof_possible_no_ch_genes
GPR137	lof_possible_no_ch_genes
SCUBE2	lof_possible_no_ch_genes
CSTF3	lof_possible_no_ch_genes
DEAF1	lof_possible_no_ch_genes
PIDD1	lof_possible_no_ch_genes
POGLUT3	lof_possible_no_ch_genes
IGSF22	lof_possible_no_ch_genes
CCDC89	lof_possible_no_ch_genes
HARBI1	lof_possible_no_ch_genes
SLC36A4	lof_possible_no_ch_genes
C11orf42	lof_possible_no_ch_genes
OR52D1	lof_possible_no_ch_genes
B4GALNT4	lof_possible_no_ch_genes
PKP3	lof_possible_no_ch_genes
ATL3	lof_possible_no_ch_genes
MUC6	lof_possible_no_ch_genes
SLC22A10	lof_possible_no_ch_genes
DYNC2H1	lof_possible_no_ch_genes
C11orf95	lof_possible_no_ch_genes
MUC2	lof_possible_no_ch_genes
SELENOH	lof_possible_no_ch_genes
VSTM5	lof_possible_no_ch_genes
TRIM64C	lof_possible_no_ch_genes
FDXACB1	lof_possible_no_ch_genes
TRIM6-TRIM34	lof_possible_no_ch_genes
VSIG10L2	lof_possible_no_ch_genes
VEZT	lof_possible_no_ch_genes
LETMD1	lof_possible_no_ch_genes
PKP2	lof_possible_no_ch_genes
STYK1	lof_possible_no_ch_genes
MON2	lof_possible_no_ch_genes
EIF4B	lof_possible_no_ch_genes
TM7SF3	lof_possible_no_ch_genes
ERBB3	lof_possible_no_ch_genes
KDM5A	lof_possible_no_ch_genes
ACTR6	lof_possible_no_ch_genes
BAZ2A	lof_possible_no_ch_genes
ACACB	lof_possible_no_ch_genes
TULP3	lof_possible_no_ch_genes
SSH1	lof_possible_no_ch_genes
ERGIC2	lof_possible_no_ch_genes
SLC8B1	lof_possible_no_ch_genes
RPH3A	lof_possible_no_ch_genes
DAO	lof_possible_no_ch_genes
CAMKK2	lof_possible_no_ch_genes
KRT18	lof_possible_no_ch_genes
ACSS3	lof_possible_no_ch_genes
TNS2	lof_possible_no_ch_genes
WNT5B	lof_possible_no_ch_genes
FOXM1	lof_possible_no_ch_genes
ARHGDIB	lof_possible_no_ch_genes
DDX55	lof_possible_no_ch_genes
MDM1	lof_possible_no_ch_genes
GAPDH	lof_possible_no_ch_genes
PTPN6	lof_possible_no_ch_genes
C2CD5	lof_possible_no_ch_genes
IRAG2	lof_possible_no_ch_genes
IQSEC3	lof_possible_no_ch_genes
UTP20	lof_possible_no_ch_genes
WASHC3	lof_possible_no_ch_genes
CIT	lof_possible_no_ch_genes
DDX54	lof_possible_no_ch_genes
MMP19	lof_possible_no_ch_genes
HOXC12	lof_possible_no_ch_genes
IKZF4	lof_possible_no_ch_genes
CCNT1	lof_possible_no_ch_genes
TMTC1	lof_possible_no_ch_genes
IPO8	lof_possible_no_ch_genes
PPHLN1	lof_possible_no_ch_genes
USP30	lof_possible_no_ch_genes
ITGA7	lof_possible_no_ch_genes
SLC26A10	lof_possible_no_ch_genes
ISCU	lof_possible_no_ch_genes
ALDH1L2	lof_possible_no_ch_genes
USP44	lof_possible_no_ch_genes
PLXNC1	lof_possible_no_ch_genes
B4GALNT3	lof_possible_no_ch_genes
CD27	lof_possible_no_ch_genes
LRIG3	lof_possible_no_ch_genes
PTPRQ	lof_possible_no_ch_genes
POC1B	lof_possible_no_ch_genes
NEDD1	lof_possible_no_ch_genes
MAP3K12	lof_possible_no_ch_genes
ABCB9	lof_possible_no_ch_genes
C12orf45	lof_possible_no_ch_genes
AMN1	lof_possible_no_ch_genes
BICD1	lof_possible_no_ch_genes
PFKM	lof_possible_no_ch_genes
FMNL3	lof_possible_no_ch_genes
RACGAP1	lof_possible_no_ch_genes
DEPDC4	lof_possible_no_ch_genes
IQCD	lof_possible_no_ch_genes
MARS1	lof_possible_no_ch_genes
MBD6	lof_possible_no_ch_genes
KRT80	lof_possible_no_ch_genes
TCTN2	lof_possible_no_ch_genes
KRT75	lof_possible_no_ch_genes
MUCL1	lof_possible_no_ch_genes
CCDC63	lof_possible_no_ch_genes
SLC2A14	lof_possible_no_ch_genes
RESF1	lof_possible_no_ch_genes
A2M	lof_possible_no_ch_genes
UNC119B	lof_possible_no_ch_genes
DNAJC22	lof_possible_no_ch_genes
HOXC9	lof_possible_no_ch_genes
ARL6IP4	lof_possible_no_ch_genes
GALNT9	lof_possible_no_ch_genes
SNRNP35	lof_possible_no_ch_genes
NOC4L	lof_possible_no_ch_genes
LRRK2	lof_possible_no_ch_genes
NCOR2	lof_possible_no_ch_genes
NACA	lof_possible_no_ch_genes
MFAP5	lof_possible_no_ch_genes
RASSF9	lof_possible_no_ch_genes
LRRC10	lof_possible_no_ch_genes
LRCOL1	lof_possible_no_ch_genes
KRT6A	lof_possible_no_ch_genes
MUC19	lof_possible_no_ch_genes
FBXL3	lof_possible_no_ch_genes
IFT88	lof_possible_no_ch_genes
FRY	lof_possible_no_ch_genes
HTR2A	lof_possible_no_ch_genes
DGKH	lof_possible_no_ch_genes
MEDAG	lof_possible_no_ch_genes
DNAJC15	lof_possible_no_ch_genes
CLYBL	lof_possible_no_ch_genes
ABCC4	lof_possible_no_ch_genes
XPO4	lof_possible_no_ch_genes
LMO7	lof_possible_no_ch_genes
SETDB2	lof_possible_no_ch_genes
SLC46A3	lof_possible_no_ch_genes
LNX2	lof_possible_no_ch_genes
BRCA2	lof_possible_no_ch_genes
ESD	lof_possible_no_ch_genes
FOXO1	lof_possible_no_ch_genes
SACS	lof_possible_no_ch_genes
CENPJ	lof_possible_no_ch_genes
MICU2	lof_possible_no_ch_genes
CBY2	lof_possible_no_ch_genes
ATP4B	lof_possible_no_ch_genes
NEK5	lof_possible_no_ch_genes
AL592490.1	lof_possible_no_ch_genes
PCDH20	lof_possible_no_ch_genes
ANGEL1	lof_possible_no_ch_genes
SPATA7	lof_possible_no_ch_genes
PTPN21	lof_possible_no_ch_genes
PSEN1	lof_possible_no_ch_genes
EXD2	lof_possible_no_ch_genes
CMA1	lof_possible_no_ch_genes
PPP2R3C	lof_possible_no_ch_genes
RPGRIP1	lof_possible_no_ch_genes
CEP170B	lof_possible_no_ch_genes
PYGL	lof_possible_no_ch_genes
DAAM1	lof_possible_no_ch_genes
ISM2	lof_possible_no_ch_genes
CEP128	lof_possible_no_ch_genes
PSMC1	lof_possible_no_ch_genes
PAPLN	lof_possible_no_ch_genes
ACIN1	lof_possible_no_ch_genes
CHD8	lof_possible_no_ch_genes
DCAF4	lof_possible_no_ch_genes
VSX2	lof_possible_no_ch_genes
NEK9	lof_possible_no_ch_genes
NRDE2	lof_possible_no_ch_genes
BMP4	lof_possible_no_ch_genes
ADCY4	lof_possible_no_ch_genes
EAPP	lof_possible_no_ch_genes
ACTR10	lof_possible_no_ch_genes
CIDEB	lof_possible_no_ch_genes
REM2	lof_possible_no_ch_genes
NAA30	lof_possible_no_ch_genes
SLC24A4	lof_possible_no_ch_genes
MBIP	lof_possible_no_ch_genes
OXA1L	lof_possible_no_ch_genes
MIDEAS	lof_possible_no_ch_genes
DHRS4	lof_possible_no_ch_genes
CFL2	lof_possible_no_ch_genes
ASPG	lof_possible_no_ch_genes
PLD4	lof_possible_no_ch_genes
PTGDR	lof_possible_no_ch_genes
MGAT2	lof_possible_no_ch_genes
GPR137C	lof_possible_no_ch_genes
BTBD6	lof_possible_no_ch_genes
JAG2	lof_possible_no_ch_genes
BRF1	lof_possible_no_ch_genes
SERPINA3	lof_possible_no_ch_genes
NOP9	lof_possible_no_ch_genes
SLC25A29	lof_possible_no_ch_genes
CDC42BPB	lof_possible_no_ch_genes
AP1G2	lof_possible_no_ch_genes
HOMEZ	lof_possible_no_ch_genes
CHMP4A	lof_possible_no_ch_genes
AL136295.1	lof_possible_no_ch_genes
NEDD4	lof_possible_no_ch_genes
SLC24A1	lof_possible_no_ch_genes
SPG21	lof_possible_no_ch_genes
TRPM7	lof_possible_no_ch_genes
CAPN3	lof_possible_no_ch_genes
IQCH	lof_possible_no_ch_genes
CEMIP	lof_possible_no_ch_genes
RPAP1	lof_possible_no_ch_genes
CEP152	lof_possible_no_ch_genes
TJP1	lof_possible_no_ch_genes
MYO5C	lof_possible_no_ch_genes
CALML4	lof_possible_no_ch_genes
THAP10	lof_possible_no_ch_genes
ADAMTS7	lof_possible_no_ch_genes
ALPK3	lof_possible_no_ch_genes
ITGA11	lof_possible_no_ch_genes
SMAD6	lof_possible_no_ch_genes
SLC28A2	lof_possible_no_ch_genes
USP8	lof_possible_no_ch_genes
SEMA7A	lof_possible_no_ch_genes
NIPA2	lof_possible_no_ch_genes
ZSCAN29	lof_possible_no_ch_genes
BNIP2	lof_possible_no_ch_genes
ARRDC4	lof_possible_no_ch_genes
ULK3	lof_possible_no_ch_genes
CYP1A2	lof_possible_no_ch_genes
MFGE8	lof_possible_no_ch_genes
CERS3	lof_possible_no_ch_genes
ADAMTSL3	lof_possible_no_ch_genes
WHAMM	lof_possible_no_ch_genes
RNF111	lof_possible_no_ch_genes
MYO1E	lof_possible_no_ch_genes
PPP1R14D	lof_possible_no_ch_genes
CATSPER2	lof_possible_no_ch_genes
PLIN1	lof_possible_no_ch_genes
VPS39	lof_possible_no_ch_genes
EPB42	lof_possible_no_ch_genes
TERB2	lof_possible_no_ch_genes
ADAL	lof_possible_no_ch_genes
FOXB1	lof_possible_no_ch_genes
ARNT2	lof_possible_no_ch_genes
REC114	lof_possible_no_ch_genes
FAN1	lof_possible_no_ch_genes
GANC	lof_possible_no_ch_genes
KBTBD13	lof_possible_no_ch_genes
AGBL1	lof_possible_no_ch_genes
AC084756.2	lof_possible_no_ch_genes
RHBDF1	lof_possible_no_ch_genes
TMEM159	lof_possible_no_ch_genes
RIPOR1	lof_possible_no_ch_genes
ACSM2B	lof_possible_no_ch_genes
SLC12A3	lof_possible_no_ch_genes
RGS11	lof_possible_no_ch_genes
PALB2	lof_possible_no_ch_genes
LPCAT2	lof_possible_no_ch_genes
TNRC6A	lof_possible_no_ch_genes
MAPK3	lof_possible_no_ch_genes
NUP93	lof_possible_no_ch_genes
TSNAXIP1	lof_possible_no_ch_genes
NDRG4	lof_possible_no_ch_genes
SETD6	lof_possible_no_ch_genes
HAS3	lof_possible_no_ch_genes
NME4	lof_possible_no_ch_genes
SLC7A5	lof_possible_no_ch_genes
PIEZO1	lof_possible_no_ch_genes
PRSS33	lof_possible_no_ch_genes
HMOX2	lof_possible_no_ch_genes
RPGRIP1L	lof_possible_no_ch_genes
RNF40	lof_possible_no_ch_genes
SLC12A4	lof_possible_no_ch_genes
GFER	lof_possible_no_ch_genes
PKMYT1	lof_possible_no_ch_genes
ERN2	lof_possible_no_ch_genes
KIAA0513	lof_possible_no_ch_genes
PMM2	lof_possible_no_ch_genes
ITGAX	lof_possible_no_ch_genes
ZFHX3	lof_possible_no_ch_genes
ADAMTS18	lof_possible_no_ch_genes
NOB1	lof_possible_no_ch_genes
TBX6	lof_possible_no_ch_genes
TLCD3B	lof_possible_no_ch_genes
DOC2A	lof_possible_no_ch_genes
TXNDC11	lof_possible_no_ch_genes
CMIP	lof_possible_no_ch_genes
FBRS	lof_possible_no_ch_genes
ITGAD	lof_possible_no_ch_genes
FCSK	lof_possible_no_ch_genes
ZDHHC1	lof_possible_no_ch_genes
HS3ST6	lof_possible_no_ch_genes
BICDL2	lof_possible_no_ch_genes
CDH16	lof_possible_no_ch_genes
DPEP2	lof_possible_no_ch_genes
MVD	lof_possible_no_ch_genes
CDT1	lof_possible_no_ch_genes
ABCA3	lof_possible_no_ch_genes
SRRM2	lof_possible_no_ch_genes
MLKL	lof_possible_no_ch_genes
UMOD	lof_possible_no_ch_genes
ITGAM	lof_possible_no_ch_genes
SHCBP1	lof_possible_no_ch_genes
VAT1L	lof_possible_no_ch_genes
CES2	lof_possible_no_ch_genes
PRSS36	lof_possible_no_ch_genes
APOBR	lof_possible_no_ch_genes
ZFP90	lof_possible_no_ch_genes
ZNF267	lof_possible_no_ch_genes
SLX4	lof_possible_no_ch_genes
ERI2	lof_possible_no_ch_genes
METTL9	lof_possible_no_ch_genes
CES1	lof_possible_no_ch_genes
C16orf96	lof_possible_no_ch_genes
DNASE1	lof_possible_no_ch_genes
PTX4	lof_possible_no_ch_genes
HP	lof_possible_no_ch_genes
SMIM22	lof_possible_no_ch_genes
PAGR1	lof_possible_no_ch_genes
LASP1	lof_possible_no_ch_genes
LIG3	lof_possible_no_ch_genes
KIAA0100	lof_possible_no_ch_genes
SCN4A	lof_possible_no_ch_genes
MRC2	lof_possible_no_ch_genes
NME1-NME2	lof_possible_no_ch_genes
UTP18	lof_possible_no_ch_genes
ST6GALNAC1	lof_possible_no_ch_genes
ST6GALNAC2	lof_possible_no_ch_genes
SCARF1	lof_possible_no_ch_genes
ZZEF1	lof_possible_no_ch_genes
ITGAE	lof_possible_no_ch_genes
APOH	lof_possible_no_ch_genes
KRT23	lof_possible_no_ch_genes
CRYBA1	lof_possible_no_ch_genes
RUNDC3A	lof_possible_no_ch_genes
RAD51C	lof_possible_no_ch_genes
KRT37	lof_possible_no_ch_genes
CDK5RAP3	lof_possible_no_ch_genes
INTS2	lof_possible_no_ch_genes
DHX58	lof_possible_no_ch_genes
KAT2A	lof_possible_no_ch_genes
CNTNAP1	lof_possible_no_ch_genes
ALOX12	lof_possible_no_ch_genes
MED1	lof_possible_no_ch_genes
WNK4	lof_possible_no_ch_genes
METTL16	lof_possible_no_ch_genes
USP6	lof_possible_no_ch_genes
QRICH2	lof_possible_no_ch_genes
RHBDF2	lof_possible_no_ch_genes
C1QL1	lof_possible_no_ch_genes
TNS4	lof_possible_no_ch_genes
TOP2A	lof_possible_no_ch_genes
SERPINF1	lof_possible_no_ch_genes
ITGB4	lof_possible_no_ch_genes
TRIM47	lof_possible_no_ch_genes
MPRIP	lof_possible_no_ch_genes
PTRH2	lof_possible_no_ch_genes
MINK1	lof_possible_no_ch_genes
SAT2	lof_possible_no_ch_genes
CCDC40	lof_possible_no_ch_genes
CARD14	lof_possible_no_ch_genes
TRIM65	lof_possible_no_ch_genes
CEP131	lof_possible_no_ch_genes
STAC2	lof_possible_no_ch_genes
ANKFN1	lof_possible_no_ch_genes
CXCL16	lof_possible_no_ch_genes
CCDC182	lof_possible_no_ch_genes
MAPK7	lof_possible_no_ch_genes
ENGASE	lof_possible_no_ch_genes
FASN	lof_possible_no_ch_genes
KRT19	lof_possible_no_ch_genes
KRT20	lof_possible_no_ch_genes
BPTF	lof_possible_no_ch_genes
SLFN12	lof_possible_no_ch_genes
RAB37	lof_possible_no_ch_genes
JUP	lof_possible_no_ch_genes
RNF213	lof_possible_no_ch_genes
KRT28	lof_possible_no_ch_genes
PPM1E	lof_possible_no_ch_genes
MYO1D	lof_possible_no_ch_genes
ALOX15B	lof_possible_no_ch_genes
PIPOX	lof_possible_no_ch_genes
MEIOC	lof_possible_no_ch_genes
SLC47A2	lof_possible_no_ch_genes
ZFP3	lof_possible_no_ch_genes
CUEDC1	lof_possible_no_ch_genes
AATK	lof_possible_no_ch_genes
USH1G	lof_possible_no_ch_genes
TSEN54	lof_possible_no_ch_genes
MXRA7	lof_possible_no_ch_genes
GALR2	lof_possible_no_ch_genes
OTOP3	lof_possible_no_ch_genes
DNAH2	lof_possible_no_ch_genes
SPPL2C	lof_possible_no_ch_genes
CCDC137	lof_possible_no_ch_genes
RAD51D	lof_possible_no_ch_genes
KIF18B	lof_possible_no_ch_genes
KRT26	lof_possible_no_ch_genes
KRT10	lof_possible_no_ch_genes
C17orf58	lof_possible_no_ch_genes
KRT14	lof_possible_no_ch_genes
KRTAP17-1	lof_possible_no_ch_genes
KRTAP9-8	lof_possible_no_ch_genes
SIRT7	lof_possible_no_ch_genes
FBF1	lof_possible_no_ch_genes
SHPK	lof_possible_no_ch_genes
CSHL1	lof_possible_no_ch_genes
KRT40	lof_possible_no_ch_genes
KRT25	lof_possible_no_ch_genes
TRIM16	lof_possible_no_ch_genes
NME2	lof_possible_no_ch_genes
AC005324.3	lof_possible_no_ch_genes
GH1	lof_possible_no_ch_genes
AC004223.3	lof_possible_no_ch_genes
RASL10B	lof_possible_no_ch_genes
RDM1	lof_possible_no_ch_genes
AC127029.3	lof_possible_no_ch_genes
LAMA3	lof_possible_no_ch_genes
LMAN1	lof_possible_no_ch_genes
NDC80	lof_possible_no_ch_genes
ATP8B1	lof_possible_no_ch_genes
ST8SIA5	lof_possible_no_ch_genes
POLI	lof_possible_no_ch_genes
RBBP8	lof_possible_no_ch_genes
RIOK3	lof_possible_no_ch_genes
TTR	lof_possible_no_ch_genes
NFATC1	lof_possible_no_ch_genes
EMILIN2	lof_possible_no_ch_genes
DSG3	lof_possible_no_ch_genes
ELP2	lof_possible_no_ch_genes
GREB1L	lof_possible_no_ch_genes
PPP4R1	lof_possible_no_ch_genes
CCDC178	lof_possible_no_ch_genes
HDHD2	lof_possible_no_ch_genes
SIGLEC15	lof_possible_no_ch_genes
PIGN	lof_possible_no_ch_genes
C18orf63	lof_possible_no_ch_genes
FUZ	lof_possible_no_ch_genes
WIZ	lof_possible_no_ch_genes
CD22	lof_possible_no_ch_genes
NLRP2	lof_possible_no_ch_genes
PNPLA6	lof_possible_no_ch_genes
PNKP	lof_possible_no_ch_genes
HOMER3	lof_possible_no_ch_genes
GPATCH1	lof_possible_no_ch_genes
COL5A3	lof_possible_no_ch_genes
CNOT3	lof_possible_no_ch_genes
FLT3LG	lof_possible_no_ch_genes
PLEKHG2	lof_possible_no_ch_genes
HOOK2	lof_possible_no_ch_genes
MAST3	lof_possible_no_ch_genes
CBARP	lof_possible_no_ch_genes
TULP2	lof_possible_no_ch_genes
TRMT1	lof_possible_no_ch_genes
AKAP8	lof_possible_no_ch_genes
ILVBL	lof_possible_no_ch_genes
ANKRD27	lof_possible_no_ch_genes
TIMM50	lof_possible_no_ch_genes
DYRK1B	lof_possible_no_ch_genes
CCNP	lof_possible_no_ch_genes
APLP1	lof_possible_no_ch_genes
TGFB1	lof_possible_no_ch_genes
NOP53	lof_possible_no_ch_genes
CD33	lof_possible_no_ch_genes
CEACAM5	lof_possible_no_ch_genes
TYK2	lof_possible_no_ch_genes
MEIS3	lof_possible_no_ch_genes
GRIN2D	lof_possible_no_ch_genes
SIGLEC6	lof_possible_no_ch_genes
LILRB5	lof_possible_no_ch_genes
PDE4C	lof_possible_no_ch_genes
SUGP1	lof_possible_no_ch_genes
PCSK4	lof_possible_no_ch_genes
GRIN3B	lof_possible_no_ch_genes
B9D2	lof_possible_no_ch_genes
EML2	lof_possible_no_ch_genes
KRI1	lof_possible_no_ch_genes
SLC44A2	lof_possible_no_ch_genes
KLK10	lof_possible_no_ch_genes
SHC2	lof_possible_no_ch_genes
BST2	lof_possible_no_ch_genes
ATG4D	lof_possible_no_ch_genes
ZC3H4	lof_possible_no_ch_genes
NAPSA	lof_possible_no_ch_genes
ZSWIM4	lof_possible_no_ch_genes
BRD4	lof_possible_no_ch_genes
NFIC	lof_possible_no_ch_genes
TPGS1	lof_possible_no_ch_genes
DUS3L	lof_possible_no_ch_genes
LMTK3	lof_possible_no_ch_genes
WTIP	lof_possible_no_ch_genes
CPAMD8	lof_possible_no_ch_genes
SHKBP1	lof_possible_no_ch_genes
RDH13	lof_possible_no_ch_genes
ZNF333	lof_possible_no_ch_genes
CCDC105	lof_possible_no_ch_genes
MFSD12	lof_possible_no_ch_genes
U2AF1L4	lof_possible_no_ch_genes
THAP8	lof_possible_no_ch_genes
TMEM143	lof_possible_no_ch_genes
KASH5	lof_possible_no_ch_genes
NIBAN3	lof_possible_no_ch_genes
TMC4	lof_possible_no_ch_genes
ZNF526	lof_possible_no_ch_genes
DNAAF3	lof_possible_no_ch_genes
DAPK3	lof_possible_no_ch_genes
ATF5	lof_possible_no_ch_genes
RLN3	lof_possible_no_ch_genes
ZNF439	lof_possible_no_ch_genes
ZNF57	lof_possible_no_ch_genes
PCP2	lof_possible_no_ch_genes
MYPOP	lof_possible_no_ch_genes
ZNF575	lof_possible_no_ch_genes
PHLDB3	lof_possible_no_ch_genes
C19orf18	lof_possible_no_ch_genes
SIX5	lof_possible_no_ch_genes
GGN	lof_possible_no_ch_genes
SYCN	lof_possible_no_ch_genes
NLRP11	lof_possible_no_ch_genes
ZNF154	lof_possible_no_ch_genes
ARHGAP45	lof_possible_no_ch_genes
ZNF571	lof_possible_no_ch_genes
ZSCAN4	lof_possible_no_ch_genes
CAPN12	lof_possible_no_ch_genes
C19orf71	lof_possible_no_ch_genes
ZNF93	lof_possible_no_ch_genes
NLRP9	lof_possible_no_ch_genes
ZNF829	lof_possible_no_ch_genes
CYP4F3	lof_possible_no_ch_genes
VSIG10L	lof_possible_no_ch_genes
LILRB4	lof_possible_no_ch_genes
EPOR	lof_possible_no_ch_genes
HAPLN4	lof_possible_no_ch_genes
ZNF559	lof_possible_no_ch_genes
SBSN	lof_possible_no_ch_genes
ZNF569	lof_possible_no_ch_genes
ZNF429	lof_possible_no_ch_genes
ZNF441	lof_possible_no_ch_genes
CYP2B6	lof_possible_no_ch_genes
CYP2A13	lof_possible_no_ch_genes
ZNF607	lof_possible_no_ch_genes
TEX45	lof_possible_no_ch_genes
LILRB3	lof_possible_no_ch_genes
PSG5	lof_possible_no_ch_genes
ONECUT3	lof_possible_no_ch_genes
ZNF726	lof_possible_no_ch_genes
LILRA4	lof_possible_no_ch_genes
PSG2	lof_possible_no_ch_genes
ZNF350	lof_possible_no_ch_genes
IFNL4	lof_possible_no_ch_genes
AC008397.2	lof_possible_no_ch_genes
RIPOR3	lof_possible_no_ch_genes
BCAS1	lof_possible_no_ch_genes
CST7	lof_possible_no_ch_genes
CBFA2T2	lof_possible_no_ch_genes
LZTS3	lof_possible_no_ch_genes
KIZ	lof_possible_no_ch_genes
ESF1	lof_possible_no_ch_genes
CFAP61	lof_possible_no_ch_genes
TRMT6	lof_possible_no_ch_genes
SGK2	lof_possible_no_ch_genes
IFT52	lof_possible_no_ch_genes
SALL4	lof_possible_no_ch_genes
SLC17A9	lof_possible_no_ch_genes
PTK6	lof_possible_no_ch_genes
SEC23B	lof_possible_no_ch_genes
SAMHD1	lof_possible_no_ch_genes
PAK5	lof_possible_no_ch_genes
MAPRE1	lof_possible_no_ch_genes
PXMP4	lof_possible_no_ch_genes
GCNT7	lof_possible_no_ch_genes
CTCFL	lof_possible_no_ch_genes
SNX21	lof_possible_no_ch_genes
ARFGEF2	lof_possible_no_ch_genes
ZNFX1	lof_possible_no_ch_genes
PTGIS	lof_possible_no_ch_genes
CDH26	lof_possible_no_ch_genes
C20orf85	lof_possible_no_ch_genes
PAX1	lof_possible_no_ch_genes
MKKS	lof_possible_no_ch_genes
BPIFB1	lof_possible_no_ch_genes
CEP250	lof_possible_no_ch_genes
HELZ2	lof_possible_no_ch_genes
GATA5	lof_possible_no_ch_genes
LAMA5	lof_possible_no_ch_genes
BPIFA3	lof_possible_no_ch_genes
PCED1A	lof_possible_no_ch_genes
CNBD2	lof_possible_no_ch_genes
SPINT4	lof_possible_no_ch_genes
TGM6	lof_possible_no_ch_genes
ZSWIM1	lof_possible_no_ch_genes
NANP	lof_possible_no_ch_genes
L3MBTL1	lof_possible_no_ch_genes
STMN3	lof_possible_no_ch_genes
ZNF335	lof_possible_no_ch_genes
UCKL1	lof_possible_no_ch_genes
EFCAB8	lof_possible_no_ch_genes
RBM12	lof_possible_no_ch_genes
AL031681.3	lof_possible_no_ch_genes
ADAMTS5	lof_possible_no_ch_genes
HSPA13	lof_possible_no_ch_genes
USP16	lof_possible_no_ch_genes
BACH1	lof_possible_no_ch_genes
ERG	lof_possible_no_ch_genes
LCA5L	lof_possible_no_ch_genes
CFAP298	lof_possible_no_ch_genes
RUNX1	lof_possible_no_ch_genes
UBASH3A	lof_possible_no_ch_genes
PDE9A	lof_possible_no_ch_genes
LRRC3	lof_possible_no_ch_genes
GRIK1	lof_possible_no_ch_genes
ZBTB21	lof_possible_no_ch_genes
COL18A1	lof_possible_no_ch_genes
IGSF5	lof_possible_no_ch_genes
RIPK4	lof_possible_no_ch_genes
BRWD1	lof_possible_no_ch_genes
SETD4	lof_possible_no_ch_genes
LTN1	lof_possible_no_ch_genes
CFAP298-TCP10L	lof_possible_no_ch_genes
TPTE	lof_possible_no_ch_genes
BID	lof_possible_no_ch_genes
CLTCL1	lof_possible_no_ch_genes
SELENOO	lof_possible_no_ch_genes
COMT	lof_possible_no_ch_genes
MMP11	lof_possible_no_ch_genes
P2RX6	lof_possible_no_ch_genes
PES1	lof_possible_no_ch_genes
SRRD	lof_possible_no_ch_genes
TFIP11	lof_possible_no_ch_genes
SLC5A1	lof_possible_no_ch_genes
SLC5A4	lof_possible_no_ch_genes
CYP2D6	lof_possible_no_ch_genes
TCF20	lof_possible_no_ch_genes
FBXO7	lof_possible_no_ch_genes
HMOX1	lof_possible_no_ch_genes
TTLL12	lof_possible_no_ch_genes
PNPLA3	lof_possible_no_ch_genes
FOXRED2	lof_possible_no_ch_genes
TUBGCP6	lof_possible_no_ch_genes
BAIAP2L2	lof_possible_no_ch_genes
TTLL8	lof_possible_no_ch_genes
RGL4	lof_possible_no_ch_genes
VPREB1	lof_possible_no_ch_genes
PRR14L	lof_possible_no_ch_genes
KREMEN1	lof_possible_no_ch_genes
INPP5J	lof_possible_no_ch_genes
TMPRSS6	lof_possible_no_ch_genes
CRYBA4	lof_possible_no_ch_genes
PLXNB2	lof_possible_no_ch_genes
CPT1B	lof_possible_no_ch_genes
CCDC188	lof_possible_no_ch_genes
MIF	lof_possible_no_ch_genes
SCARF2	lof_possible_no_ch_genes
ZNF280B	lof_possible_no_ch_genes
MTMR11	lof_high_ch_genes
COL16A1	lof_high_ch_genes
TNNI3K	lof_high_ch_genes
HAO2	lof_high_ch_genes
ZP4	lof_high_ch_genes
GBP1	lof_high_ch_genes
CR2	lof_high_ch_genes
RSRP1	lof_high_ch_genes
RGSL1	lof_high_ch_genes
RAB25	lof_high_ch_genes
CAPN9	lof_high_ch_genes
CFAP74	lof_high_ch_genes
FHAD1	lof_high_ch_genes
PADI1	lof_high_ch_genes
SYTL1	lof_high_ch_genes
ADCY10	lof_high_ch_genes
CGN	lof_high_ch_genes
ADAM15	lof_high_ch_genes
OBSCN	lof_high_ch_genes
DRAXIN	lof_high_ch_genes
TMCO4	lof_high_ch_genes
MEGF6	lof_high_ch_genes
CCDC27	lof_high_ch_genes
PGLYRP4	lof_high_ch_genes
IGFN1	lof_high_ch_genes
SLFNL1	lof_high_ch_genes
RNPEP	lof_high_ch_genes
FCRL6	lof_high_ch_genes
CLCNKA	lof_high_ch_genes
ANKRD35	lof_high_ch_genes
DISP3	lof_high_ch_genes
CYB5RL	lof_high_ch_genes
C1orf167	lof_high_ch_genes
FPGT-TNNI3K	lof_high_ch_genes
GCFC2	lof_high_ch_genes
MYO3B	lof_high_ch_genes
MPP4	lof_high_ch_genes
IFIH1	lof_high_ch_genes
GCA	lof_high_ch_genes
DNAH6	lof_high_ch_genes
PASK	lof_high_ch_genes
QPCT	lof_high_ch_genes
ALMS1	lof_high_ch_genes
DNAH7	lof_high_ch_genes
CYP20A1	lof_high_ch_genes
METTL8	lof_high_ch_genes
TNFAIP6	lof_high_ch_genes
OBSL1	lof_high_ch_genes
TTLL4	lof_high_ch_genes
ANKRD36	lof_high_ch_genes
ASNSD1	lof_high_ch_genes
FASTKD1	lof_high_ch_genes
UNC80	lof_high_ch_genes
ANKMY1	lof_high_ch_genes
ANKAR	lof_high_ch_genes
G6PC2	lof_high_ch_genes
PLEKHH2	lof_high_ch_genes
TTN	lof_high_ch_genes
DRC1	lof_high_ch_genes
XDH	lof_high_ch_genes
CCDC138	lof_high_ch_genes
CCDC74A	lof_high_ch_genes
TEKT4	lof_high_ch_genes
ASB18	lof_high_ch_genes
KIAA2012	lof_high_ch_genes
NEB	lof_high_ch_genes
MROH2A	lof_high_ch_genes
FSIP2	lof_high_ch_genes
WDSUB1	lof_high_ch_genes
VIT	lof_high_ch_genes
RAD51AP2	lof_high_ch_genes
CROCC2	lof_high_ch_genes
FAM237A	lof_high_ch_genes
UGT1A3	lof_high_ch_genes
DLEC1	lof_high_ch_genes
POLQ	lof_high_ch_genes
MCF2L2	lof_high_ch_genes
ITIH1	lof_high_ch_genes
EHHADH	lof_high_ch_genes
EFCC1	lof_high_ch_genes
IRAK2	lof_high_ch_genes
CNTN6	lof_high_ch_genes
FANCD2	lof_high_ch_genes
MUC4	lof_high_ch_genes
ABI3BP	lof_high_ch_genes
XPC	lof_high_ch_genes
TRIM42	lof_high_ch_genes
ERICH6	lof_high_ch_genes
MST1R	lof_high_ch_genes
ULK4	lof_high_ch_genes
SCN11A	lof_high_ch_genes
RIOX2	lof_high_ch_genes
COL6A5	lof_high_ch_genes
WDR49	lof_high_ch_genes
ATR	lof_high_ch_genes
GPR156	lof_high_ch_genes
SCN10A	lof_high_ch_genes
ATP13A5	lof_high_ch_genes
KBTBD12	lof_high_ch_genes
VEPH1	lof_high_ch_genes
COL6A6	lof_high_ch_genes
TTLL3	lof_high_ch_genes
ARPC4-TTLL3	lof_high_ch_genes
CD38	lof_high_ch_genes
FAM184B	lof_high_ch_genes
SH3BP2	lof_high_ch_genes
WFS1	lof_high_ch_genes
CORIN	lof_high_ch_genes
SPATA4	lof_high_ch_genes
TDO2	lof_high_ch_genes
TMPRSS11D	lof_high_ch_genes
UGT2A1	lof_high_ch_genes
TLR1	lof_high_ch_genes
AMBN	lof_high_ch_genes
DDX60L	lof_high_ch_genes
ADH1B	lof_high_ch_genes
DCHS2	lof_high_ch_genes
CNGA1	lof_high_ch_genes
C4orf54	lof_high_ch_genes
ASIC5	lof_high_ch_genes
UGT2A2	lof_high_ch_genes
CDHR2	lof_high_ch_genes
DELE1	lof_high_ch_genes
SLC4A9	lof_high_ch_genes
MSH3	lof_high_ch_genes
ATP10B	lof_high_ch_genes
POLK	lof_high_ch_genes
SPINK5	lof_high_ch_genes
ADAM19	lof_high_ch_genes
OTULINL	lof_high_ch_genes
IQGAP2	lof_high_ch_genes
ADAMTS12	lof_high_ch_genes
SPEF2	lof_high_ch_genes
PLEKHG4B	lof_high_ch_genes
SLC45A2	lof_high_ch_genes
BTNL9	lof_high_ch_genes
GPR151	lof_high_ch_genes
PHYKPL	lof_high_ch_genes
LRRC70	lof_high_ch_genes
CPLANE1	lof_high_ch_genes
FCHSD1	lof_high_ch_genes
RANBP17	lof_high_ch_genes
ITGA1	lof_high_ch_genes
KIF4B	lof_high_ch_genes
PCDHAC1	lof_high_ch_genes
PCDHGA5	lof_high_ch_genes
PCDHGB3	lof_high_ch_genes
OPRM1	lof_high_ch_genes
SLC26A8	lof_high_ch_genes
ZNF451	lof_high_ch_genes
GPLD1	lof_high_ch_genes
CRYBG1	lof_high_ch_genes
VNN1	lof_high_ch_genes
CCDC170	lof_high_ch_genes
DNAH8	lof_high_ch_genes
COL21A1	lof_high_ch_genes
AK9	lof_high_ch_genes
SAMD3	lof_high_ch_genes
PI16	lof_high_ch_genes
KIF6	lof_high_ch_genes
SLC22A1	lof_high_ch_genes
TDRD6	lof_high_ch_genes
THBS2	lof_high_ch_genes
ECT2L	lof_high_ch_genes
SLC25A13	lof_high_ch_genes
CROT	lof_high_ch_genes
CHPF2	lof_high_ch_genes
SLC13A1	lof_high_ch_genes
DNAH11	lof_high_ch_genes
IQCE	lof_high_ch_genes
HSPB1	lof_high_ch_genes
CYP3A5	lof_high_ch_genes
HYAL4	lof_high_ch_genes
CPA4	lof_high_ch_genes
ADCK2	lof_high_ch_genes
KCP	lof_high_ch_genes
SPDYE1	lof_high_ch_genes
GPNMB	lof_high_ch_genes
MMD2	lof_high_ch_genes
PKD1L1	lof_high_ch_genes
MUC17	lof_high_ch_genes
AMZ1	lof_high_ch_genes
ABCA13	lof_high_ch_genes
ZNF467	lof_high_ch_genes
GSTK1	lof_high_ch_genes
LRRD1	lof_high_ch_genes
MGAM	lof_high_ch_genes
POM121C	lof_high_ch_genes
MYOM2	lof_high_ch_genes
TG	lof_high_ch_genes
ADAM28	lof_high_ch_genes
CDH17	lof_high_ch_genes
TRPA1	lof_high_ch_genes
TNFRSF10A	lof_high_ch_genes
SORBS3	lof_high_ch_genes
TEX15	lof_high_ch_genes
MCPH1	lof_high_ch_genes
PXDNL	lof_high_ch_genes
NAPRT	lof_high_ch_genes
DPY19L4	lof_high_ch_genes
LETM2	lof_high_ch_genes
C8orf34	lof_high_ch_genes
TRHR	lof_high_ch_genes
MSRA	lof_high_ch_genes
FBXL6	lof_high_ch_genes
RP1L1	lof_high_ch_genes
TOP1MT	lof_high_ch_genes
CDCA2	lof_high_ch_genes
COL14A1	lof_high_ch_genes
NUGGC	lof_high_ch_genes
PKHD1L1	lof_high_ch_genes
KCNU1	lof_high_ch_genes
NUDT18	lof_high_ch_genes
PRUNE2	lof_high_ch_genes
SUSD1	lof_high_ch_genes
KANK1	lof_high_ch_genes
CNTRL	lof_high_ch_genes
ACO1	lof_high_ch_genes
DDX31	lof_high_ch_genes
WDR31	lof_high_ch_genes
HMCN2	lof_high_ch_genes
CCDC171	lof_high_ch_genes
CERCAM	lof_high_ch_genes
TPRN	lof_high_ch_genes
SSNA1	lof_high_ch_genes
DPP7	lof_high_ch_genes
MAMDC4	lof_high_ch_genes
EXD3	lof_high_ch_genes
NOXA1	lof_high_ch_genes
CCDC180	lof_high_ch_genes
GSTO2	lof_high_ch_genes
SEC31B	lof_high_ch_genes
NEBL	lof_high_ch_genes
WASHC2A	lof_high_ch_genes
CUBN	lof_high_ch_genes
CDH23	lof_high_ch_genes
SFXN3	lof_high_ch_genes
CFAP58	lof_high_ch_genes
MYOF	lof_high_ch_genes
LOXL4	lof_high_ch_genes
ITIH2	lof_high_ch_genes
C10orf90	lof_high_ch_genes
CFAP46	lof_high_ch_genes
MMRN2	lof_high_ch_genes
PTCHD3	lof_high_ch_genes
AKR1C1	lof_high_ch_genes
ASAH2	lof_high_ch_genes
AKR1C3	lof_high_ch_genes
MALRD1	lof_high_ch_genes
USH1C	lof_high_ch_genes
CD44	lof_high_ch_genes
DGAT2	lof_high_ch_genes
VWA5A	lof_high_ch_genes
APOA4	lof_high_ch_genes
SNX19	lof_high_ch_genes
RRP8	lof_high_ch_genes
C11orf1	lof_high_ch_genes
NLRP14	lof_high_ch_genes
NLRX1	lof_high_ch_genes
PPP1R32	lof_high_ch_genes
DEUP1	lof_high_ch_genes
ALKBH3	lof_high_ch_genes
MMP10	lof_high_ch_genes
SAAL1	lof_high_ch_genes
SNX32	lof_high_ch_genes
RPS6KB2	lof_high_ch_genes
DNHD1	lof_high_ch_genes
C11orf54	lof_high_ch_genes
OVCH2	lof_high_ch_genes
IRF7	lof_high_ch_genes
LMNTD2	lof_high_ch_genes
TRIM64B	lof_high_ch_genes
SLC22A25	lof_high_ch_genes
POLR3B	lof_high_ch_genes
ANO2	lof_high_ch_genes
P3H3	lof_high_ch_genes
PZP	lof_high_ch_genes
LRRIQ1	lof_high_ch_genes
STAB2	lof_high_ch_genes
APPL2	lof_high_ch_genes
PIK3C2G	lof_high_ch_genes
LGR5	lof_high_ch_genes
SLC39A5	lof_high_ch_genes
CSAD	lof_high_ch_genes
CFAP251	lof_high_ch_genes
LRRC43	lof_high_ch_genes
A2ML1	lof_high_ch_genes
MYO1A	lof_high_ch_genes
SOAT2	lof_high_ch_genes
CLEC12A	lof_high_ch_genes
ADAMTS20	lof_high_ch_genes
MYO1H	lof_high_ch_genes
ANO6	lof_high_ch_genes
SLC17A8	lof_high_ch_genes
KNTC1	lof_high_ch_genes
OVCH1	lof_high_ch_genes
CFAP54	lof_high_ch_genes
SLC15A5	lof_high_ch_genes
DNAH10	lof_high_ch_genes
CEP290	lof_high_ch_genes
ATXN2	lof_high_ch_genes
ACSM4	lof_high_ch_genes
ATP12A	lof_high_ch_genes
VWA8	lof_high_ch_genes
MTRF1	lof_high_ch_genes
UPF3A	lof_high_ch_genes
SERPINE3	lof_high_ch_genes
NIN	lof_high_ch_genes
KIAA0586	lof_high_ch_genes
PCK2	lof_high_ch_genes
HEATR5A	lof_high_ch_genes
TEP1	lof_high_ch_genes
ABHD12B	lof_high_ch_genes
TTC6	lof_high_ch_genes
TSSK4	lof_high_ch_genes
FAM161B	lof_high_ch_genes
TC2N	lof_high_ch_genes
VPS13C	lof_high_ch_genes
UACA	lof_high_ch_genes
DUOX1	lof_high_ch_genes
STRA6	lof_high_ch_genes
SPTBN5	lof_high_ch_genes
DUOX2	lof_high_ch_genes
MCTP2	lof_high_ch_genes
MEGF11	lof_high_ch_genes
STARD9	lof_high_ch_genes
MESP1	lof_high_ch_genes
JMJD7-PLA2G4B	lof_high_ch_genes
AKAP13	lof_high_ch_genes
STARD5	lof_high_ch_genes
IGDCC3	lof_high_ch_genes
SYNM	lof_high_ch_genes
GOLGA6B	lof_high_ch_genes
PLA2G4B	lof_high_ch_genes
NOX5	lof_high_ch_genes
BAIAP3	lof_high_ch_genes
MVP	lof_high_ch_genes
HSD17B2	lof_high_ch_genes
ABCC6	lof_high_ch_genes
PHKB	lof_high_ch_genes
MPG	lof_high_ch_genes
METTL26	lof_high_ch_genes
NOL3	lof_high_ch_genes
HIRIP3	lof_high_ch_genes
DNAH3	lof_high_ch_genes
SLC5A11	lof_high_ch_genes
LRRC36	lof_high_ch_genes
WDR90	lof_high_ch_genes
SLC38A8	lof_high_ch_genes
KCNG4	lof_high_ch_genes
PDILT	lof_high_ch_genes
AC099489.1	lof_high_ch_genes
SPG7	lof_high_ch_genes
PKD1L3	lof_high_ch_genes
SARM1	lof_high_ch_genes
MYH13	lof_high_ch_genes
DNAH9	lof_high_ch_genes
HEATR6	lof_high_ch_genes
MYO15A	lof_high_ch_genes
RECQL5	lof_high_ch_genes
CHRNE	lof_high_ch_genes
MYH1	lof_high_ch_genes
MYH2	lof_high_ch_genes
PLD2	lof_high_ch_genes
MYH8	lof_high_ch_genes
C17orf80	lof_high_ch_genes
SGSM2	lof_high_ch_genes
ABCA8	lof_high_ch_genes
ZMYND15	lof_high_ch_genes
SLC5A10	lof_high_ch_genes
ABCA10	lof_high_ch_genes
PRPSAP1	lof_high_ch_genes
ACSF2	lof_high_ch_genes
RSKR	lof_high_ch_genes
EVPL	lof_high_ch_genes
CCDC144A	lof_high_ch_genes
ALOXE3	lof_high_ch_genes
RNF135	lof_high_ch_genes
NAA38	lof_high_ch_genes
ADAP2	lof_high_ch_genes
SMYD4	lof_high_ch_genes
DNAH17	lof_high_ch_genes
KIF19	lof_high_ch_genes
TRPV1	lof_high_ch_genes
KIAA0753	lof_high_ch_genes
TNFRSF13B	lof_high_ch_genes
AC005726.1	lof_high_ch_genes
MYH4	lof_high_ch_genes
HEATR9	lof_high_ch_genes
PIK3R6	lof_high_ch_genes
CTDP1	lof_high_ch_genes
MOCOS	lof_high_ch_genes
LOXHD1	lof_high_ch_genes
ANKRD30B	lof_high_ch_genes
ZSCAN30	lof_high_ch_genes
MRI1	lof_high_ch_genes
ABCA7	lof_high_ch_genes
PTPRH	lof_high_ch_genes
CERS4	lof_high_ch_genes
CATSPERG	lof_high_ch_genes
DHDH	lof_high_ch_genes
KLC3	lof_high_ch_genes
SULT2A1	lof_high_ch_genes
BCL2L12	lof_high_ch_genes
ADGRE2	lof_high_ch_genes
DOCK6	lof_high_ch_genes
TRPM4	lof_high_ch_genes
ANGPTL6	lof_high_ch_genes
NLRP12	lof_high_ch_genes
FBN3	lof_high_ch_genes
PWWP3A	lof_high_ch_genes
PSG6	lof_high_ch_genes
ZNF440	lof_high_ch_genes
WDR87	lof_high_ch_genes
NLRP13	lof_high_ch_genes
FAM187B	lof_high_ch_genes
NLRP8	lof_high_ch_genes
MUC16	lof_high_ch_genes
NWD1	lof_high_ch_genes
ZNF181	lof_high_ch_genes
ZNF560	lof_high_ch_genes
ZNF667	lof_high_ch_genes
RGL3	lof_high_ch_genes
PSG1	lof_high_ch_genes
PSG4	lof_high_ch_genes
SIGLEC12	lof_high_ch_genes
AC011455.2	lof_high_ch_genes
FCGBP	lof_high_ch_genes
MYH7B	lof_high_ch_genes
LPIN3	lof_high_ch_genes
ADAM33	lof_high_ch_genes
TRPM2	lof_high_ch_genes
DOP1B	lof_high_ch_genes
TMPRSS15	lof_high_ch_genes
AIRE	lof_high_ch_genes
TRIOBP	lof_high_ch_genes
PARVG	lof_high_ch_genes
EFCAB6	lof_high_ch_genes
CCDC157	lof_high_ch_genes
SFI1	lof_high_ch_genes
ARFGAP3	lof_high_ch_genes
NIPAL3	lof_high_possible_no_ch_genes
TTC22	lof_high_possible_no_ch_genes
MASP2	lof_high_possible_no_ch_genes
CLCN6	lof_high_possible_no_ch_genes
CLCA4	lof_high_possible_no_ch_genes
ADSS2	lof_high_possible_no_ch_genes
USH2A	lof_high_possible_no_ch_genes
TARBP1	lof_high_possible_no_ch_genes
SPEN	lof_high_possible_no_ch_genes
PACC1	lof_high_possible_no_ch_genes
ASPM	lof_high_possible_no_ch_genes
EVI5	lof_high_possible_no_ch_genes
TGFBR3	lof_high_possible_no_ch_genes
PLXNA2	lof_high_possible_no_ch_genes
GPR137B	lof_high_possible_no_ch_genes
OVGP1	lof_high_possible_no_ch_genes
MUL1	lof_high_possible_no_ch_genes
BCL9	lof_high_possible_no_ch_genes
DNAJC16	lof_high_possible_no_ch_genes
LRRC42	lof_high_possible_no_ch_genes
NPHS2	lof_high_possible_no_ch_genes
STXBP3	lof_high_possible_no_ch_genes
ELAPOR1	lof_high_possible_no_ch_genes
ASH1L	lof_high_possible_no_ch_genes
DOCK7	lof_high_possible_no_ch_genes
PRG4	lof_high_possible_no_ch_genes
GADD45A	lof_high_possible_no_ch_genes
RO60	lof_high_possible_no_ch_genes
PLEKHM2	lof_high_possible_no_ch_genes
TTF2	lof_high_possible_no_ch_genes
NT5C1A	lof_high_possible_no_ch_genes
ST6GALNAC5	lof_high_possible_no_ch_genes
IGSF21	lof_high_possible_no_ch_genes
CDK18	lof_high_possible_no_ch_genes
PTCH2	lof_high_possible_no_ch_genes
AKR1A1	lof_high_possible_no_ch_genes
TMED5	lof_high_possible_no_ch_genes
PRRC2C	lof_high_possible_no_ch_genes
DARS2	lof_high_possible_no_ch_genes
RCOR3	lof_high_possible_no_ch_genes
ARID1A	lof_high_possible_no_ch_genes
ATF6	lof_high_possible_no_ch_genes
RAB3GAP2	lof_high_possible_no_ch_genes
TRIM67	lof_high_possible_no_ch_genes
HEATR1	lof_high_possible_no_ch_genes
ECHDC2	lof_high_possible_no_ch_genes
AUNIP	lof_high_possible_no_ch_genes
HP1BP3	lof_high_possible_no_ch_genes
PPT1	lof_high_possible_no_ch_genes
NPHP4	lof_high_possible_no_ch_genes
FMO5	lof_high_possible_no_ch_genes
PRKAB2	lof_high_possible_no_ch_genes
SPATA6	lof_high_possible_no_ch_genes
ATP1A4	lof_high_possible_no_ch_genes
DPH2	lof_high_possible_no_ch_genes
MUTYH	lof_high_possible_no_ch_genes
GSTM3	lof_high_possible_no_ch_genes
CHIA	lof_high_possible_no_ch_genes
HMGCS2	lof_high_possible_no_ch_genes
NAV1	lof_high_possible_no_ch_genes
GNL2	lof_high_possible_no_ch_genes
HOOK1	lof_high_possible_no_ch_genes
PCNX2	lof_high_possible_no_ch_genes
NIBAN1	lof_high_possible_no_ch_genes
PIGC	lof_high_possible_no_ch_genes
LAMC1	lof_high_possible_no_ch_genes
TTLL7	lof_high_possible_no_ch_genes
RABGGTB	lof_high_possible_no_ch_genes
SLC44A5	lof_high_possible_no_ch_genes
CLCA2	lof_high_possible_no_ch_genes
CNKSR1	lof_high_possible_no_ch_genes
EVA1B	lof_high_possible_no_ch_genes
HSPG2	lof_high_possible_no_ch_genes
CYP4B1	lof_high_possible_no_ch_genes
IGSF3	lof_high_possible_no_ch_genes
FNDC7	lof_high_possible_no_ch_genes
ALDH9A1	lof_high_possible_no_ch_genes
CASQ1	lof_high_possible_no_ch_genes
TOR1AIP1	lof_high_possible_no_ch_genes
ECM1	lof_high_possible_no_ch_genes
DTL	lof_high_possible_no_ch_genes
TAF1A	lof_high_possible_no_ch_genes
HHIPL2	lof_high_possible_no_ch_genes
SNAPIN	lof_high_possible_no_ch_genes
SLC39A1	lof_high_possible_no_ch_genes
INTS3	lof_high_possible_no_ch_genes
PKLR	lof_high_possible_no_ch_genes
C1orf131	lof_high_possible_no_ch_genes
GALNT2	lof_high_possible_no_ch_genes
MAP3K21	lof_high_possible_no_ch_genes
CNIH3	lof_high_possible_no_ch_genes
C1orf35	lof_high_possible_no_ch_genes
AHCTF1	lof_high_possible_no_ch_genes
SHCBP1L	lof_high_possible_no_ch_genes
C8A	lof_high_possible_no_ch_genes
SKI	lof_high_possible_no_ch_genes
PAFAH2	lof_high_possible_no_ch_genes
GRHL3	lof_high_possible_no_ch_genes
ELK4	lof_high_possible_no_ch_genes
SLC45A3	lof_high_possible_no_ch_genes
NBL1	lof_high_possible_no_ch_genes
VWA5B1	lof_high_possible_no_ch_genes
LAD1	lof_high_possible_no_ch_genes
CCDC17	lof_high_possible_no_ch_genes
IL6R	lof_high_possible_no_ch_genes
CYP4A22	lof_high_possible_no_ch_genes
CMPK1	lof_high_possible_no_ch_genes
BROX	lof_high_possible_no_ch_genes
WDR64	lof_high_possible_no_ch_genes
KIF26B	lof_high_possible_no_ch_genes
FCMR	lof_high_possible_no_ch_genes
PIGR	lof_high_possible_no_ch_genes
CAPN2	lof_high_possible_no_ch_genes
VPS72	lof_high_possible_no_ch_genes
MNDA	lof_high_possible_no_ch_genes
ZC3H12A	lof_high_possible_no_ch_genes
C1orf50	lof_high_possible_no_ch_genes
SERINC2	lof_high_possible_no_ch_genes
PCSK9	lof_high_possible_no_ch_genes
EFNA1	lof_high_possible_no_ch_genes
LUZP1	lof_high_possible_no_ch_genes
METTL18	lof_high_possible_no_ch_genes
ANGPTL7	lof_high_possible_no_ch_genes
MTHFR	lof_high_possible_no_ch_genes
TMEM125	lof_high_possible_no_ch_genes
HTR1D	lof_high_possible_no_ch_genes
SELENOF	lof_high_possible_no_ch_genes
H3C13	lof_high_possible_no_ch_genes
CLCNKB	lof_high_possible_no_ch_genes
SMYD3	lof_high_possible_no_ch_genes
AGBL4	lof_high_possible_no_ch_genes
CYP4Z1	lof_high_possible_no_ch_genes
CYP4X1	lof_high_possible_no_ch_genes
FOXD2	lof_high_possible_no_ch_genes
ESPN	lof_high_possible_no_ch_genes
FOXD3	lof_high_possible_no_ch_genes
RAB42	lof_high_possible_no_ch_genes
S100A4	lof_high_possible_no_ch_genes
SEMA4A	lof_high_possible_no_ch_genes
LAMB3	lof_high_possible_no_ch_genes
MIB2	lof_high_possible_no_ch_genes
HHLA3	lof_high_possible_no_ch_genes
EFCAB7	lof_high_possible_no_ch_genes
PRAMEF17	lof_high_possible_no_ch_genes
TMEM240	lof_high_possible_no_ch_genes
RBMXL1	lof_high_possible_no_ch_genes
ANKRD65	lof_high_possible_no_ch_genes
KIAA0040	lof_high_possible_no_ch_genes
BGLAP	lof_high_possible_no_ch_genes
PRAMEF18	lof_high_possible_no_ch_genes
SLC11A1	lof_high_possible_no_ch_genes
RETSAT	lof_high_possible_no_ch_genes
CAPG	lof_high_possible_no_ch_genes
LY75	lof_high_possible_no_ch_genes
PUM2	lof_high_possible_no_ch_genes
PMS1	lof_high_possible_no_ch_genes
STON1-GTF2A1L	lof_high_possible_no_ch_genes
SRBD1	lof_high_possible_no_ch_genes
PTPN18	lof_high_possible_no_ch_genes
SPEG	lof_high_possible_no_ch_genes
ABCB11	lof_high_possible_no_ch_genes
CLASP1	lof_high_possible_no_ch_genes
DNAJC10	lof_high_possible_no_ch_genes
USP40	lof_high_possible_no_ch_genes
FAHD2A	lof_high_possible_no_ch_genes
GPD2	lof_high_possible_no_ch_genes
GALNT3	lof_high_possible_no_ch_genes
CCDC88A	lof_high_possible_no_ch_genes
FN1	lof_high_possible_no_ch_genes
PECR	lof_high_possible_no_ch_genes
IGFBP2	lof_high_possible_no_ch_genes
PLCD4	lof_high_possible_no_ch_genes
ABCB6	lof_high_possible_no_ch_genes
TAF1B	lof_high_possible_no_ch_genes
NOL10	lof_high_possible_no_ch_genes
CEBPZ	lof_high_possible_no_ch_genes
LCT	lof_high_possible_no_ch_genes
EPHA4	lof_high_possible_no_ch_genes
NCAPH	lof_high_possible_no_ch_genes
HJURP	lof_high_possible_no_ch_genes
TTC21B	lof_high_possible_no_ch_genes
VIL1	lof_high_possible_no_ch_genes
HOXD1	lof_high_possible_no_ch_genes
MTX2	lof_high_possible_no_ch_genes
PDE11A	lof_high_possible_no_ch_genes
HOXD13	lof_high_possible_no_ch_genes
PXDN	lof_high_possible_no_ch_genes
SAG	lof_high_possible_no_ch_genes
PER2	lof_high_possible_no_ch_genes
RAMP1	lof_high_possible_no_ch_genes
EGR4	lof_high_possible_no_ch_genes
DYSF	lof_high_possible_no_ch_genes
WNT10A	lof_high_possible_no_ch_genes
GALNT5	lof_high_possible_no_ch_genes
SMPD4	lof_high_possible_no_ch_genes
UGGT1	lof_high_possible_no_ch_genes
SELENOI	lof_high_possible_no_ch_genes
CYP1B1	lof_high_possible_no_ch_genes
TRIM54	lof_high_possible_no_ch_genes
ATIC	lof_high_possible_no_ch_genes
BARD1	lof_high_possible_no_ch_genes
NAB1	lof_high_possible_no_ch_genes
CDK15	lof_high_possible_no_ch_genes
MDH1B	lof_high_possible_no_ch_genes
ITPRID2	lof_high_possible_no_ch_genes
WDR12	lof_high_possible_no_ch_genes
ABI2	lof_high_possible_no_ch_genes
ITGAV	lof_high_possible_no_ch_genes
GDF7	lof_high_possible_no_ch_genes
CAMKMT	lof_high_possible_no_ch_genes
PKP4	lof_high_possible_no_ch_genes
PTH2R	lof_high_possible_no_ch_genes
NBEAL1	lof_high_possible_no_ch_genes
KANSL1L	lof_high_possible_no_ch_genes
NYAP2	lof_high_possible_no_ch_genes
ALLC	lof_high_possible_no_ch_genes
MFSD6	lof_high_possible_no_ch_genes
BOLL	lof_high_possible_no_ch_genes
RASGRP3	lof_high_possible_no_ch_genes
ANAPC1	lof_high_possible_no_ch_genes
RGPD3	lof_high_possible_no_ch_genes
ATP5MC3	lof_high_possible_no_ch_genes
CNTNAP5	lof_high_possible_no_ch_genes
EIF5B	lof_high_possible_no_ch_genes
PKDCC	lof_high_possible_no_ch_genes
TYW5	lof_high_possible_no_ch_genes
SLC16A14	lof_high_possible_no_ch_genes
BBS5	lof_high_possible_no_ch_genes
ARHGAP25	lof_high_possible_no_ch_genes
TMEM169	lof_high_possible_no_ch_genes
GLB1L	lof_high_possible_no_ch_genes
PLB1	lof_high_possible_no_ch_genes
KIF5C	lof_high_possible_no_ch_genes
E2F6	lof_high_possible_no_ch_genes
SCN9A	lof_high_possible_no_ch_genes
APLF	lof_high_possible_no_ch_genes
BUB1	lof_high_possible_no_ch_genes
LIMS1	lof_high_possible_no_ch_genes
HOXD12	lof_high_possible_no_ch_genes
FAM161A	lof_high_possible_no_ch_genes
FEZ2	lof_high_possible_no_ch_genes
ALK	lof_high_possible_no_ch_genes
ECEL1	lof_high_possible_no_ch_genes
REG1B	lof_high_possible_no_ch_genes
KLF11	lof_high_possible_no_ch_genes
UBXN2A	lof_high_possible_no_ch_genes
NCKAP5	lof_high_possible_no_ch_genes
RBM44	lof_high_possible_no_ch_genes
PLEKHM3	lof_high_possible_no_ch_genes
FOXD4L1	lof_high_possible_no_ch_genes
FAM110C	lof_high_possible_no_ch_genes
SEPTIN10	lof_high_possible_no_ch_genes
SESTD1	lof_high_possible_no_ch_genes
CERKL	lof_high_possible_no_ch_genes
SLC4A5	lof_high_possible_no_ch_genes
RFX8	lof_high_possible_no_ch_genes
RGPD4	lof_high_possible_no_ch_genes
SULT1C2	lof_high_possible_no_ch_genes
CDKL4	lof_high_possible_no_ch_genes
SP9	lof_high_possible_no_ch_genes
DYTN	lof_high_possible_no_ch_genes
STPG4	lof_high_possible_no_ch_genes
STON1	lof_high_possible_no_ch_genes
LY75-CD302	lof_high_possible_no_ch_genes
AC093899.2	lof_high_possible_no_ch_genes
PPP4R3B	lof_high_possible_no_ch_genes
RBM5	lof_high_possible_no_ch_genes
CELSR3	lof_high_possible_no_ch_genes
LTF	lof_high_possible_no_ch_genes
SLC4A7	lof_high_possible_no_ch_genes
ASTE1	lof_high_possible_no_ch_genes
DCBLD2	lof_high_possible_no_ch_genes
TNK2	lof_high_possible_no_ch_genes
PPP2R3A	lof_high_possible_no_ch_genes
ST6GAL1	lof_high_possible_no_ch_genes
LXN	lof_high_possible_no_ch_genes
KIF9	lof_high_possible_no_ch_genes
CDV3	lof_high_possible_no_ch_genes
OGG1	lof_high_possible_no_ch_genes
PCCB	lof_high_possible_no_ch_genes
CEP70	lof_high_possible_no_ch_genes
GRK7	lof_high_possible_no_ch_genes
XRN1	lof_high_possible_no_ch_genes
SERPINI2	lof_high_possible_no_ch_genes
COL7A1	lof_high_possible_no_ch_genes
GNB4	lof_high_possible_no_ch_genes
FRMD4B	lof_high_possible_no_ch_genes
CISH	lof_high_possible_no_ch_genes
EIF4G1	lof_high_possible_no_ch_genes
SEC22A	lof_high_possible_no_ch_genes
TNFSF10	lof_high_possible_no_ch_genes
ATP13A4	lof_high_possible_no_ch_genes
MBD4	lof_high_possible_no_ch_genes
RBSN	lof_high_possible_no_ch_genes
SLC25A26	lof_high_possible_no_ch_genes
NXPE3	lof_high_possible_no_ch_genes
MYH15	lof_high_possible_no_ch_genes
BOC	lof_high_possible_no_ch_genes
TMEM44	lof_high_possible_no_ch_genes
ECE2	lof_high_possible_no_ch_genes
NGLY1	lof_high_possible_no_ch_genes
QTRT2	lof_high_possible_no_ch_genes
KLHL40	lof_high_possible_no_ch_genes
DZIP1L	lof_high_possible_no_ch_genes
ESYT3	lof_high_possible_no_ch_genes
FAIM	lof_high_possible_no_ch_genes
MYL3	lof_high_possible_no_ch_genes
FBLN2	lof_high_possible_no_ch_genes
CLASP2	lof_high_possible_no_ch_genes
CD200R1	lof_high_possible_no_ch_genes
SPICE1	lof_high_possible_no_ch_genes
ATXN7	lof_high_possible_no_ch_genes
PRICKLE2	lof_high_possible_no_ch_genes
PTX3	lof_high_possible_no_ch_genes
IL17RE	lof_high_possible_no_ch_genes
PRRT3	lof_high_possible_no_ch_genes
GYG1	lof_high_possible_no_ch_genes
HPS3	lof_high_possible_no_ch_genes
RYK	lof_high_possible_no_ch_genes
KIF15	lof_high_possible_no_ch_genes
FYCO1	lof_high_possible_no_ch_genes
DTX3L	lof_high_possible_no_ch_genes
YEATS2	lof_high_possible_no_ch_genes
IFT122	lof_high_possible_no_ch_genes
TKT	lof_high_possible_no_ch_genes
TASOR	lof_high_possible_no_ch_genes
SLC51A	lof_high_possible_no_ch_genes
PLXNB1	lof_high_possible_no_ch_genes
ATRIP	lof_high_possible_no_ch_genes
ZBBX	lof_high_possible_no_ch_genes
HSPBAP1	lof_high_possible_no_ch_genes
BTD	lof_high_possible_no_ch_genes
SUCLG2	lof_high_possible_no_ch_genes
PARP15	lof_high_possible_no_ch_genes
SLCO2A1	lof_high_possible_no_ch_genes
RSRC1	lof_high_possible_no_ch_genes
DHX36	lof_high_possible_no_ch_genes
ZIC4	lof_high_possible_no_ch_genes
ZNF654	lof_high_possible_no_ch_genes
USF3	lof_high_possible_no_ch_genes
B3GNT5	lof_high_possible_no_ch_genes
ALS2CL	lof_high_possible_no_ch_genes
GRAMD1C	lof_high_possible_no_ch_genes
C3orf38	lof_high_possible_no_ch_genes
HCLS1	lof_high_possible_no_ch_genes
HMCES	lof_high_possible_no_ch_genes
TRAIP	lof_high_possible_no_ch_genes
TPRG1	lof_high_possible_no_ch_genes
OSTN	lof_high_possible_no_ch_genes
ZKSCAN7	lof_high_possible_no_ch_genes
PIK3R4	lof_high_possible_no_ch_genes
CD200R1L	lof_high_possible_no_ch_genes
SPINK8	lof_high_possible_no_ch_genes
GPX1	lof_high_possible_no_ch_genes
CCDC13	lof_high_possible_no_ch_genes
AC006059.2	lof_high_possible_no_ch_genes
CCDC39	lof_high_possible_no_ch_genes
EEF1AKMT4-ECE2	lof_high_possible_no_ch_genes
LAP3	lof_high_possible_no_ch_genes
RUFY3	lof_high_possible_no_ch_genes
UBA6	lof_high_possible_no_ch_genes
CC2D2A	lof_high_possible_no_ch_genes
FNIP2	lof_high_possible_no_ch_genes
TXK	lof_high_possible_no_ch_genes
N4BP2	lof_high_possible_no_ch_genes
CRACD	lof_high_possible_no_ch_genes
NFKB1	lof_high_possible_no_ch_genes
AREG	lof_high_possible_no_ch_genes
ELF2	lof_high_possible_no_ch_genes
SEPSECS	lof_high_possible_no_ch_genes
SLC2A9	lof_high_possible_no_ch_genes
MFSD10	lof_high_possible_no_ch_genes
BST1	lof_high_possible_no_ch_genes
SPP1	lof_high_possible_no_ch_genes
SH3TC1	lof_high_possible_no_ch_genes
PAICS	lof_high_possible_no_ch_genes
POLN	lof_high_possible_no_ch_genes
KLB	lof_high_possible_no_ch_genes
UGT2B28	lof_high_possible_no_ch_genes
CPEB2	lof_high_possible_no_ch_genes
TTC29	lof_high_possible_no_ch_genes
DDX60	lof_high_possible_no_ch_genes
HERC5	lof_high_possible_no_ch_genes
ZGRF1	lof_high_possible_no_ch_genes
MMRN1	lof_high_possible_no_ch_genes
PDE5A	lof_high_possible_no_ch_genes
TRPC3	lof_high_possible_no_ch_genes
FRAS1	lof_high_possible_no_ch_genes
PPA2	lof_high_possible_no_ch_genes
PYURF	lof_high_possible_no_ch_genes
RNF175	lof_high_possible_no_ch_genes
MMAA	lof_high_possible_no_ch_genes
DMP1	lof_high_possible_no_ch_genes
ADGRA3	lof_high_possible_no_ch_genes
UGT2B4	lof_high_possible_no_ch_genes
AASDH	lof_high_possible_no_ch_genes
SPON2	lof_high_possible_no_ch_genes
HPGDS	lof_high_possible_no_ch_genes
C4orf36	lof_high_possible_no_ch_genes
AIMP1	lof_high_possible_no_ch_genes
INTU	lof_high_possible_no_ch_genes
C4orf3	lof_high_possible_no_ch_genes
MAP9	lof_high_possible_no_ch_genes
OTUD4	lof_high_possible_no_ch_genes
ZCCHC4	lof_high_possible_no_ch_genes
ZBTB49	lof_high_possible_no_ch_genes
SLC49A3	lof_high_possible_no_ch_genes
USP38	lof_high_possible_no_ch_genes
NFXL1	lof_high_possible_no_ch_genes
NUDT6	lof_high_possible_no_ch_genes
LARP7	lof_high_possible_no_ch_genes
SRP72	lof_high_possible_no_ch_genes
ODAPH	lof_high_possible_no_ch_genes
BTC	lof_high_possible_no_ch_genes
FREM3	lof_high_possible_no_ch_genes
CCSER1	lof_high_possible_no_ch_genes
NPY2R	lof_high_possible_no_ch_genes
DEFB131A	lof_high_possible_no_ch_genes
SOWAHB	lof_high_possible_no_ch_genes
QRFPR	lof_high_possible_no_ch_genes
ADH7	lof_high_possible_no_ch_genes
TMPRSS11F	lof_high_possible_no_ch_genes
C4orf46	lof_high_possible_no_ch_genes
CFI	lof_high_possible_no_ch_genes
ARHGEF38	lof_high_possible_no_ch_genes
AC126283.2	lof_high_possible_no_ch_genes
FLT4	lof_high_possible_no_ch_genes
SOX30	lof_high_possible_no_ch_genes
JADE2	lof_high_possible_no_ch_genes
COL23A1	lof_high_possible_no_ch_genes
PRDM6	lof_high_possible_no_ch_genes
TCOF1	lof_high_possible_no_ch_genes
P4HA2	lof_high_possible_no_ch_genes
SEMA6A	lof_high_possible_no_ch_genes
CEP72	lof_high_possible_no_ch_genes
C7	lof_high_possible_no_ch_genes
GHR	lof_high_possible_no_ch_genes
MRPS30	lof_high_possible_no_ch_genes
MRPS27	lof_high_possible_no_ch_genes
APBB3	lof_high_possible_no_ch_genes
BTNL8	lof_high_possible_no_ch_genes
RAD50	lof_high_possible_no_ch_genes
PPWD1	lof_high_possible_no_ch_genes
C9	lof_high_possible_no_ch_genes
MYOT	lof_high_possible_no_ch_genes
FASTKD3	lof_high_possible_no_ch_genes
EPB41L4A	lof_high_possible_no_ch_genes
BHMT2	lof_high_possible_no_ch_genes
HSD17B4	lof_high_possible_no_ch_genes
CCNB1	lof_high_possible_no_ch_genes
IL6ST	lof_high_possible_no_ch_genes
OSMR	lof_high_possible_no_ch_genes
PPIP5K2	lof_high_possible_no_ch_genes
BDP1	lof_high_possible_no_ch_genes
TSLP	lof_high_possible_no_ch_genes
FEM1C	lof_high_possible_no_ch_genes
CXCL14	lof_high_possible_no_ch_genes
DDX46	lof_high_possible_no_ch_genes
RNF44	lof_high_possible_no_ch_genes
PARP8	lof_high_possible_no_ch_genes
CDH12	lof_high_possible_no_ch_genes
GRAMD2B	lof_high_possible_no_ch_genes
SLC26A2	lof_high_possible_no_ch_genes
LSM11	lof_high_possible_no_ch_genes
HK3	lof_high_possible_no_ch_genes
MGAT4B	lof_high_possible_no_ch_genes
ELOVL7	lof_high_possible_no_ch_genes
RANBP3L	lof_high_possible_no_ch_genes
AGGF1	lof_high_possible_no_ch_genes
SCGB3A2	lof_high_possible_no_ch_genes
CMYA5	lof_high_possible_no_ch_genes
NSA2	lof_high_possible_no_ch_genes
SLC6A18	lof_high_possible_no_ch_genes
IL31RA	lof_high_possible_no_ch_genes
ANKRD55	lof_high_possible_no_ch_genes
NSD1	lof_high_possible_no_ch_genes
ACTBL2	lof_high_possible_no_ch_genes
RGS14	lof_high_possible_no_ch_genes
HARS1	lof_high_possible_no_ch_genes
C5orf34	lof_high_possible_no_ch_genes
ZNF131	lof_high_possible_no_ch_genes
DMXL1	lof_high_possible_no_ch_genes
GPR150	lof_high_possible_no_ch_genes
FAM153B	lof_high_possible_no_ch_genes
RXFP3	lof_high_possible_no_ch_genes
PLCXD3	lof_high_possible_no_ch_genes
DDX41	lof_high_possible_no_ch_genes
SLC36A2	lof_high_possible_no_ch_genes
RGS7BP	lof_high_possible_no_ch_genes
TBC1D9B	lof_high_possible_no_ch_genes
FAM169A	lof_high_possible_no_ch_genes
PCDHA7	lof_high_possible_no_ch_genes
PCDHA5	lof_high_possible_no_ch_genes
ARHGEF28	lof_high_possible_no_ch_genes
PCDHGC5	lof_high_possible_no_ch_genes
EIF4EBP3	lof_high_possible_no_ch_genes
PCDHGB6	lof_high_possible_no_ch_genes
PCDHGA8	lof_high_possible_no_ch_genes
PCDHGB7	lof_high_possible_no_ch_genes
ANKHD1-EIF4EBP3	lof_high_possible_no_ch_genes
PCDHGA4	lof_high_possible_no_ch_genes
AC116366.2	lof_high_possible_no_ch_genes
TFAP2D	lof_high_possible_no_ch_genes
REV3L	lof_high_possible_no_ch_genes
PGM3	lof_high_possible_no_ch_genes
UBR2	lof_high_possible_no_ch_genes
ROS1	lof_high_possible_no_ch_genes
UHRF1BP1	lof_high_possible_no_ch_genes
EPB41L2	lof_high_possible_no_ch_genes
OSTM1	lof_high_possible_no_ch_genes
EFHC1	lof_high_possible_no_ch_genes
ITPR3	lof_high_possible_no_ch_genes
DSP	lof_high_possible_no_ch_genes
CEP85L	lof_high_possible_no_ch_genes
MCM9	lof_high_possible_no_ch_genes
GABRR2	lof_high_possible_no_ch_genes
BAG2	lof_high_possible_no_ch_genes
RAB23	lof_high_possible_no_ch_genes
BVES	lof_high_possible_no_ch_genes
MED23	lof_high_possible_no_ch_genes
ACOT13	lof_high_possible_no_ch_genes
SLC17A2	lof_high_possible_no_ch_genes
FIG4	lof_high_possible_no_ch_genes
UNC93A	lof_high_possible_no_ch_genes
SLC22A2	lof_high_possible_no_ch_genes
CCND3	lof_high_possible_no_ch_genes
PRPH2	lof_high_possible_no_ch_genes
CUL9	lof_high_possible_no_ch_genes
SENP6	lof_high_possible_no_ch_genes
VEGFA	lof_high_possible_no_ch_genes
CCN6	lof_high_possible_no_ch_genes
ENPP5	lof_high_possible_no_ch_genes
PRSS16	lof_high_possible_no_ch_genes
TBX18	lof_high_possible_no_ch_genes
ADGB	lof_high_possible_no_ch_genes
AKAP7	lof_high_possible_no_ch_genes
PLEKHG1	lof_high_possible_no_ch_genes
TTLL2	lof_high_possible_no_ch_genes
ABCC10	lof_high_possible_no_ch_genes
UNC5CL	lof_high_possible_no_ch_genes
KLHDC3	lof_high_possible_no_ch_genes
TREM1	lof_high_possible_no_ch_genes
MEA1	lof_high_possible_no_ch_genes
RIOK1	lof_high_possible_no_ch_genes
DEK	lof_high_possible_no_ch_genes
ERMARD	lof_high_possible_no_ch_genes
ULBP3	lof_high_possible_no_ch_genes
CEP162	lof_high_possible_no_ch_genes
NMBR	lof_high_possible_no_ch_genes
FOXF2	lof_high_possible_no_ch_genes
MDC1	lof_high_possible_no_ch_genes
FAM8A1	lof_high_possible_no_ch_genes
SLC17A4	lof_high_possible_no_ch_genes
TCTE1	lof_high_possible_no_ch_genes
TPBG	lof_high_possible_no_ch_genes
TBC1D32	lof_high_possible_no_ch_genes
RNF217	lof_high_possible_no_ch_genes
PNLDC1	lof_high_possible_no_ch_genes
VIP	lof_high_possible_no_ch_genes
SLC22A3	lof_high_possible_no_ch_genes
UTRN	lof_high_possible_no_ch_genes
RAET1L	lof_high_possible_no_ch_genes
ZSCAN12	lof_high_possible_no_ch_genes
SLC35A1	lof_high_possible_no_ch_genes
TMEM200A	lof_high_possible_no_ch_genes
FAM83B	lof_high_possible_no_ch_genes
POLH	lof_high_possible_no_ch_genes
THEMIS	lof_high_possible_no_ch_genes
ZC3H12D	lof_high_possible_no_ch_genes
TMEM151B	lof_high_possible_no_ch_genes
POU3F2	lof_high_possible_no_ch_genes
RFX6	lof_high_possible_no_ch_genes
TREML4	lof_high_possible_no_ch_genes
EYS	lof_high_possible_no_ch_genes
ZNF292	lof_high_possible_no_ch_genes
ZKSCAN3	lof_high_possible_no_ch_genes
L3MBTL3	lof_high_possible_no_ch_genes
BTNL2	lof_high_possible_no_ch_genes
SLC44A4	lof_high_possible_no_ch_genes
LSM2	lof_high_possible_no_ch_genes
MPIG6B	lof_high_possible_no_ch_genes
LY6G6F	lof_high_possible_no_ch_genes
MICA	lof_high_possible_no_ch_genes
DHX16	lof_high_possible_no_ch_genes
TAAR9	lof_high_possible_no_ch_genes
CFB	lof_high_possible_no_ch_genes
AL645922.1	lof_high_possible_no_ch_genes
ERVFRD-1	lof_high_possible_no_ch_genes
LY6G6F-LY6G6D	lof_high_possible_no_ch_genes
MUC22	lof_high_possible_no_ch_genes
RPS10-NUDT3	lof_high_possible_no_ch_genes
NUDT3	lof_high_possible_no_ch_genes
ASB4	lof_high_possible_no_ch_genes
KDM7A	lof_high_possible_no_ch_genes
PHTF2	lof_high_possible_no_ch_genes
SCIN	lof_high_possible_no_ch_genes
NUB1	lof_high_possible_no_ch_genes
NPC1L1	lof_high_possible_no_ch_genes
TBXAS1	lof_high_possible_no_ch_genes
PARP12	lof_high_possible_no_ch_genes
SEMA3C	lof_high_possible_no_ch_genes
LRCH4	lof_high_possible_no_ch_genes
ZCWPW1	lof_high_possible_no_ch_genes
ADCYAP1R1	lof_high_possible_no_ch_genes
LAMB4	lof_high_possible_no_ch_genes
DLD	lof_high_possible_no_ch_genes
STEAP1B	lof_high_possible_no_ch_genes
HOXA6	lof_high_possible_no_ch_genes
COBL	lof_high_possible_no_ch_genes
PLEKHA8	lof_high_possible_no_ch_genes
EPHB6	lof_high_possible_no_ch_genes
EIF3B	lof_high_possible_no_ch_genes
MEOX2	lof_high_possible_no_ch_genes
POU6F2	lof_high_possible_no_ch_genes
AEBP1	lof_high_possible_no_ch_genes
PMS2	lof_high_possible_no_ch_genes
FKBP9	lof_high_possible_no_ch_genes
KIAA1549	lof_high_possible_no_ch_genes
LRRC61	lof_high_possible_no_ch_genes
CDHR3	lof_high_possible_no_ch_genes
FOXP2	lof_high_possible_no_ch_genes
IFT22	lof_high_possible_no_ch_genes
IRF5	lof_high_possible_no_ch_genes
SUMF2	lof_high_possible_no_ch_genes
DPP6	lof_high_possible_no_ch_genes
ARPC1B	lof_high_possible_no_ch_genes
DMTF1	lof_high_possible_no_ch_genes
C7orf25	lof_high_possible_no_ch_genes
NUP42	lof_high_possible_no_ch_genes
AOAH	lof_high_possible_no_ch_genes
TBRG4	lof_high_possible_no_ch_genes
HUS1	lof_high_possible_no_ch_genes
NACAD	lof_high_possible_no_ch_genes
VWDE	lof_high_possible_no_ch_genes
IGFBP3	lof_high_possible_no_ch_genes
EPHA1	lof_high_possible_no_ch_genes
NOM1	lof_high_possible_no_ch_genes
NUP205	lof_high_possible_no_ch_genes
SLC37A3	lof_high_possible_no_ch_genes
TSPAN33	lof_high_possible_no_ch_genes
CPA5	lof_high_possible_no_ch_genes
FAM131B	lof_high_possible_no_ch_genes
PPP1R35	lof_high_possible_no_ch_genes
STK17A	lof_high_possible_no_ch_genes
COG5	lof_high_possible_no_ch_genes
NEUROD6	lof_high_possible_no_ch_genes
STEAP1	lof_high_possible_no_ch_genes
CDCA7L	lof_high_possible_no_ch_genes
DNAAF5	lof_high_possible_no_ch_genes
MPLKIP	lof_high_possible_no_ch_genes
TMEM196	lof_high_possible_no_ch_genes
DNAJC30	lof_high_possible_no_ch_genes
UPP1	lof_high_possible_no_ch_genes
MACC1	lof_high_possible_no_ch_genes
IKZF1	lof_high_possible_no_ch_genes
PCLO	lof_high_possible_no_ch_genes
TRRAP	lof_high_possible_no_ch_genes
ZNF138	lof_high_possible_no_ch_genes
HOXA4	lof_high_possible_no_ch_genes
ZNF277	lof_high_possible_no_ch_genes
TYW1	lof_high_possible_no_ch_genes
SLC35B4	lof_high_possible_no_ch_genes
GPC2	lof_high_possible_no_ch_genes
GNAT3	lof_high_possible_no_ch_genes
FAM133B	lof_high_possible_no_ch_genes
AC004922.1	lof_high_possible_no_ch_genes
ANK1	lof_high_possible_no_ch_genes
NSMAF	lof_high_possible_no_ch_genes
MSR1	lof_high_possible_no_ch_genes
TAF2	lof_high_possible_no_ch_genes
ZFAT	lof_high_possible_no_ch_genes
CPSF1	lof_high_possible_no_ch_genes
ZFHX4	lof_high_possible_no_ch_genes
ZDHHC2	lof_high_possible_no_ch_genes
STK3	lof_high_possible_no_ch_genes
UBXN8	lof_high_possible_no_ch_genes
ARHGEF10	lof_high_possible_no_ch_genes
CLU	lof_high_possible_no_ch_genes
MTUS1	lof_high_possible_no_ch_genes
TTI2	lof_high_possible_no_ch_genes
VPS13B	lof_high_possible_no_ch_genes
E2F5	lof_high_possible_no_ch_genes
RNF122	lof_high_possible_no_ch_genes
DSCC1	lof_high_possible_no_ch_genes
SULF1	lof_high_possible_no_ch_genes
TRIM55	lof_high_possible_no_ch_genes
FAM83A	lof_high_possible_no_ch_genes
RAB11FIP1	lof_high_possible_no_ch_genes
UNC5D	lof_high_possible_no_ch_genes
FAM160B2	lof_high_possible_no_ch_genes
HEY1	lof_high_possible_no_ch_genes
CSMD3	lof_high_possible_no_ch_genes
SPIDR	lof_high_possible_no_ch_genes
GEM	lof_high_possible_no_ch_genes
TMEM67	lof_high_possible_no_ch_genes
SCARA3	lof_high_possible_no_ch_genes
HTRA4	lof_high_possible_no_ch_genes
CNGB3	lof_high_possible_no_ch_genes
ESCO2	lof_high_possible_no_ch_genes
ADCK5	lof_high_possible_no_ch_genes
FAM91A1	lof_high_possible_no_ch_genes
MCMDC2	lof_high_possible_no_ch_genes
OPLAH	lof_high_possible_no_ch_genes
POMK	lof_high_possible_no_ch_genes
ENTPD4	lof_high_possible_no_ch_genes
CNOT7	lof_high_possible_no_ch_genes
FBXO16	lof_high_possible_no_ch_genes
MROH5	lof_high_possible_no_ch_genes
OC90	lof_high_possible_no_ch_genes
PRKDC	lof_high_possible_no_ch_genes
LRRC24	lof_high_possible_no_ch_genes
AC100868.1	lof_high_possible_no_ch_genes
C8orf89	lof_high_possible_no_ch_genes
MUSK	lof_high_possible_no_ch_genes
CNTLN	lof_high_possible_no_ch_genes
FRMPD1	lof_high_possible_no_ch_genes
GBA2	lof_high_possible_no_ch_genes
SMARCA2	lof_high_possible_no_ch_genes
TBC1D2	lof_high_possible_no_ch_genes
PTGR1	lof_high_possible_no_ch_genes
AMBP	lof_high_possible_no_ch_genes
DOCK8	lof_high_possible_no_ch_genes
LHX3	lof_high_possible_no_ch_genes
GLIS3	lof_high_possible_no_ch_genes
APBA1	lof_high_possible_no_ch_genes
SETX	lof_high_possible_no_ch_genes
EXOSC3	lof_high_possible_no_ch_genes
TRPM6	lof_high_possible_no_ch_genes
FBXW2	lof_high_possible_no_ch_genes
GALNT12	lof_high_possible_no_ch_genes
MLANA	lof_high_possible_no_ch_genes
MRPS2	lof_high_possible_no_ch_genes
CKS2	lof_high_possible_no_ch_genes
TTF1	lof_high_possible_no_ch_genes
OMD	lof_high_possible_no_ch_genes
PRDM12	lof_high_possible_no_ch_genes
PRRC2B	lof_high_possible_no_ch_genes
HABP4	lof_high_possible_no_ch_genes
CDK9	lof_high_possible_no_ch_genes
ODF2	lof_high_possible_no_ch_genes
ECPAS	lof_high_possible_no_ch_genes
SMC2	lof_high_possible_no_ch_genes
CDK5RAP2	lof_high_possible_no_ch_genes
USP20	lof_high_possible_no_ch_genes
DMAC1	lof_high_possible_no_ch_genes
CCL21	lof_high_possible_no_ch_genes
CD72	lof_high_possible_no_ch_genes
IGFBPL1	lof_high_possible_no_ch_genes
DENND4C	lof_high_possible_no_ch_genes
IFNK	lof_high_possible_no_ch_genes
CEP78	lof_high_possible_no_ch_genes
GSN	lof_high_possible_no_ch_genes
MRRF	lof_high_possible_no_ch_genes
CRB2	lof_high_possible_no_ch_genes
POLE3	lof_high_possible_no_ch_genes
CIZ1	lof_high_possible_no_ch_genes
C9orf85	lof_high_possible_no_ch_genes
FBXW5	lof_high_possible_no_ch_genes
SNAPC3	lof_high_possible_no_ch_genes
FXN	lof_high_possible_no_ch_genes
KIF27	lof_high_possible_no_ch_genes
SHOC1	lof_high_possible_no_ch_genes
ZNF367	lof_high_possible_no_ch_genes
NSMF	lof_high_possible_no_ch_genes
SLC27A4	lof_high_possible_no_ch_genes
ABO	lof_high_possible_no_ch_genes
ZDHHC21	lof_high_possible_no_ch_genes
GRIN1	lof_high_possible_no_ch_genes
C8G	lof_high_possible_no_ch_genes
MAN1B1	lof_high_possible_no_ch_genes
LCN15	lof_high_possible_no_ch_genes
ADAMTSL1	lof_high_possible_no_ch_genes
C9orf50	lof_high_possible_no_ch_genes
ANKRD18A	lof_high_possible_no_ch_genes
EHMT1	lof_high_possible_no_ch_genes
NUTM2G	lof_high_possible_no_ch_genes
FOCAD	lof_high_possible_no_ch_genes
VPS13A	lof_high_possible_no_ch_genes
STKLD1	lof_high_possible_no_ch_genes
OR13C3	lof_high_possible_no_ch_genes
FAM205A	lof_high_possible_no_ch_genes
ORM1	lof_high_possible_no_ch_genes
ANKRD18B	lof_high_possible_no_ch_genes
AL358113.1	lof_high_possible_no_ch_genes
ALOX5	lof_high_possible_no_ch_genes
AIFM2	lof_high_possible_no_ch_genes
COL17A1	lof_high_possible_no_ch_genes
SEC61A2	lof_high_possible_no_ch_genes
PFKP	lof_high_possible_no_ch_genes
RHOBTB1	lof_high_possible_no_ch_genes
MYO3A	lof_high_possible_no_ch_genes
PDLIM1	lof_high_possible_no_ch_genes
PALD1	lof_high_possible_no_ch_genes
LZTS2	lof_high_possible_no_ch_genes
NPM3	lof_high_possible_no_ch_genes
GBF1	lof_high_possible_no_ch_genes
ANKRD26	lof_high_possible_no_ch_genes
NEURL1	lof_high_possible_no_ch_genes
PITRM1	lof_high_possible_no_ch_genes
PPIF	lof_high_possible_no_ch_genes
SFRP5	lof_high_possible_no_ch_genes
LDB3	lof_high_possible_no_ch_genes
PRXL2A	lof_high_possible_no_ch_genes
PLAU	lof_high_possible_no_ch_genes
SLC25A16	lof_high_possible_no_ch_genes
ECHS1	lof_high_possible_no_ch_genes
TUBGCP2	lof_high_possible_no_ch_genes
DNAJC1	lof_high_possible_no_ch_genes
MFSD13A	lof_high_possible_no_ch_genes
TACC2	lof_high_possible_no_ch_genes
ARL3	lof_high_possible_no_ch_genes
EXOC6	lof_high_possible_no_ch_genes
ADAMTS14	lof_high_possible_no_ch_genes
COMMD3	lof_high_possible_no_ch_genes
MPP7	lof_high_possible_no_ch_genes
PCDH15	lof_high_possible_no_ch_genes
DOCK1	lof_high_possible_no_ch_genes
CDC123	lof_high_possible_no_ch_genes
MARVELD1	lof_high_possible_no_ch_genes
PIK3AP1	lof_high_possible_no_ch_genes
BMS1	lof_high_possible_no_ch_genes
VWA2	lof_high_possible_no_ch_genes
UBTD1	lof_high_possible_no_ch_genes
HTRA1	lof_high_possible_no_ch_genes
PCBD1	lof_high_possible_no_ch_genes
WBP1L	lof_high_possible_no_ch_genes
AFAP1L2	lof_high_possible_no_ch_genes
HNRNPF	lof_high_possible_no_ch_genes
FAM241B	lof_high_possible_no_ch_genes
JMJD1C	lof_high_possible_no_ch_genes
WASHC2C	lof_high_possible_no_ch_genes
ZFAND4	lof_high_possible_no_ch_genes
SNCG	lof_high_possible_no_ch_genes
FZD8	lof_high_possible_no_ch_genes
SKIDA1	lof_high_possible_no_ch_genes
PPA1	lof_high_possible_no_ch_genes
RTKN2	lof_high_possible_no_ch_genes
FAM53B	lof_high_possible_no_ch_genes
NRAP	lof_high_possible_no_ch_genes
ZNF511	lof_high_possible_no_ch_genes
PAPSS2	lof_high_possible_no_ch_genes
LDB1	lof_high_possible_no_ch_genes
LIPN	lof_high_possible_no_ch_genes
LIPJ	lof_high_possible_no_ch_genes
DNAJC9	lof_high_possible_no_ch_genes
CCDC7	lof_high_possible_no_ch_genes
HOGA1	lof_high_possible_no_ch_genes
ZNF511-PRAP1	lof_high_possible_no_ch_genes
POLA2	lof_high_possible_no_ch_genes
QSER1	lof_high_possible_no_ch_genes
NXPE1	lof_high_possible_no_ch_genes
SNX15	lof_high_possible_no_ch_genes
ATG2A	lof_high_possible_no_ch_genes
DCPS	lof_high_possible_no_ch_genes
NRXN2	lof_high_possible_no_ch_genes
KIAA1549L	lof_high_possible_no_ch_genes
ACCS	lof_high_possible_no_ch_genes
POU2AF1	lof_high_possible_no_ch_genes
USP35	lof_high_possible_no_ch_genes
TRIM6	lof_high_possible_no_ch_genes
FRMD8	lof_high_possible_no_ch_genes
LSP1	lof_high_possible_no_ch_genes
PPFIA1	lof_high_possible_no_ch_genes
CNGA4	lof_high_possible_no_ch_genes
ACY3	lof_high_possible_no_ch_genes
TESMIN	lof_high_possible_no_ch_genes
LGALS12	lof_high_possible_no_ch_genes
SWAP70	lof_high_possible_no_ch_genes
ANO3	lof_high_possible_no_ch_genes
NAT10	lof_high_possible_no_ch_genes
RNF121	lof_high_possible_no_ch_genes
SORL1	lof_high_possible_no_ch_genes
BTG4	lof_high_possible_no_ch_genes
TMPRSS13	lof_high_possible_no_ch_genes
PGGHG	lof_high_possible_no_ch_genes
PAMR1	lof_high_possible_no_ch_genes
EIF3M	lof_high_possible_no_ch_genes
TENM4	lof_high_possible_no_ch_genes
INTS4	lof_high_possible_no_ch_genes
ZC3H12C	lof_high_possible_no_ch_genes
HTR3B	lof_high_possible_no_ch_genes
ATM	lof_high_possible_no_ch_genes
TKFC	lof_high_possible_no_ch_genes
FADS1	lof_high_possible_no_ch_genes
MPZL2	lof_high_possible_no_ch_genes
TMEM25	lof_high_possible_no_ch_genes
MMP3	lof_high_possible_no_ch_genes
DLG2	lof_high_possible_no_ch_genes
DIXDC1	lof_high_possible_no_ch_genes
EXT2	lof_high_possible_no_ch_genes
GDPD5	lof_high_possible_no_ch_genes
SIK3	lof_high_possible_no_ch_genes
VPS11	lof_high_possible_no_ch_genes
INPPL1	lof_high_possible_no_ch_genes
CEP295	lof_high_possible_no_ch_genes
ADAMTS15	lof_high_possible_no_ch_genes
PATL1	lof_high_possible_no_ch_genes
RNF214	lof_high_possible_no_ch_genes
C2CD3	lof_high_possible_no_ch_genes
SAC3D1	lof_high_possible_no_ch_genes
SF1	lof_high_possible_no_ch_genes
NFRKB	lof_high_possible_no_ch_genes
CDC42BPG	lof_high_possible_no_ch_genes
C2CD2L	lof_high_possible_no_ch_genes
OR5T3	lof_high_possible_no_ch_genes
CTSW	lof_high_possible_no_ch_genes
GPR137	lof_high_possible_no_ch_genes
SCUBE2	lof_high_possible_no_ch_genes
CSTF3	lof_high_possible_no_ch_genes
DEAF1	lof_high_possible_no_ch_genes
PIDD1	lof_high_possible_no_ch_genes
POGLUT3	lof_high_possible_no_ch_genes
IGSF22	lof_high_possible_no_ch_genes
CCDC89	lof_high_possible_no_ch_genes
HARBI1	lof_high_possible_no_ch_genes
SLC36A4	lof_high_possible_no_ch_genes
C11orf42	lof_high_possible_no_ch_genes
OR52D1	lof_high_possible_no_ch_genes
B4GALNT4	lof_high_possible_no_ch_genes
ATL3	lof_high_possible_no_ch_genes
MUC6	lof_high_possible_no_ch_genes
DYNC2H1	lof_high_possible_no_ch_genes
C11orf95	lof_high_possible_no_ch_genes
MUC2	lof_high_possible_no_ch_genes
VSTM5	lof_high_possible_no_ch_genes
TRIM64C	lof_high_possible_no_ch_genes
MFRP	lof_high_possible_no_ch_genes
FDXACB1	lof_high_possible_no_ch_genes
TRIM6-TRIM34	lof_high_possible_no_ch_genes
VSIG10L2	lof_high_possible_no_ch_genes
PKP2	lof_high_possible_no_ch_genes
STYK1	lof_high_possible_no_ch_genes
MON2	lof_high_possible_no_ch_genes
EIF4B	lof_high_possible_no_ch_genes
TM7SF3	lof_high_possible_no_ch_genes
ERBB3	lof_high_possible_no_ch_genes
KDM5A	lof_high_possible_no_ch_genes
ACTR6	lof_high_possible_no_ch_genes
BAZ2A	lof_high_possible_no_ch_genes
ACACB	lof_high_possible_no_ch_genes
TULP3	lof_high_possible_no_ch_genes
SSH1	lof_high_possible_no_ch_genes
SLC8B1	lof_high_possible_no_ch_genes
DAO	lof_high_possible_no_ch_genes
CAMKK2	lof_high_possible_no_ch_genes
KRT18	lof_high_possible_no_ch_genes
ACSS3	lof_high_possible_no_ch_genes
TNS2	lof_high_possible_no_ch_genes
WNT5B	lof_high_possible_no_ch_genes
FOXM1	lof_high_possible_no_ch_genes
ARHGDIB	lof_high_possible_no_ch_genes
MDM1	lof_high_possible_no_ch_genes
GAPDH	lof_high_possible_no_ch_genes
PTPN6	lof_high_possible_no_ch_genes
IRAG2	lof_high_possible_no_ch_genes
IQSEC3	lof_high_possible_no_ch_genes
UTP20	lof_high_possible_no_ch_genes
WASHC3	lof_high_possible_no_ch_genes
CIT	lof_high_possible_no_ch_genes
DDX54	lof_high_possible_no_ch_genes
MMP19	lof_high_possible_no_ch_genes
HOXC12	lof_high_possible_no_ch_genes
IKZF4	lof_high_possible_no_ch_genes
BEST3	lof_high_possible_no_ch_genes
CCNT1	lof_high_possible_no_ch_genes
TMTC1	lof_high_possible_no_ch_genes
IPO8	lof_high_possible_no_ch_genes
PPHLN1	lof_high_possible_no_ch_genes
USP30	lof_high_possible_no_ch_genes
ITGA7	lof_high_possible_no_ch_genes
SLC26A10	lof_high_possible_no_ch_genes
ISCU	lof_high_possible_no_ch_genes
ALDH1L2	lof_high_possible_no_ch_genes
USP44	lof_high_possible_no_ch_genes
B4GALNT3	lof_high_possible_no_ch_genes
CD27	lof_high_possible_no_ch_genes
LRIG3	lof_high_possible_no_ch_genes
PTPRQ	lof_high_possible_no_ch_genes
POC1B	lof_high_possible_no_ch_genes
MAP3K12	lof_high_possible_no_ch_genes
ABCB9	lof_high_possible_no_ch_genes
C12orf45	lof_high_possible_no_ch_genes
AMN1	lof_high_possible_no_ch_genes
BICD1	lof_high_possible_no_ch_genes
PFKM	lof_high_possible_no_ch_genes
FMNL3	lof_high_possible_no_ch_genes
RACGAP1	lof_high_possible_no_ch_genes
OTOGL	lof_high_possible_no_ch_genes
DEPDC4	lof_high_possible_no_ch_genes
MARS1	lof_high_possible_no_ch_genes
MBD6	lof_high_possible_no_ch_genes
KRT80	lof_high_possible_no_ch_genes
TCTN2	lof_high_possible_no_ch_genes
KRT75	lof_high_possible_no_ch_genes
MUCL1	lof_high_possible_no_ch_genes
CCDC63	lof_high_possible_no_ch_genes
SLC2A14	lof_high_possible_no_ch_genes
RESF1	lof_high_possible_no_ch_genes
A2M	lof_high_possible_no_ch_genes
DNAJC22	lof_high_possible_no_ch_genes
HOXC9	lof_high_possible_no_ch_genes
ARL6IP4	lof_high_possible_no_ch_genes
SNRNP35	lof_high_possible_no_ch_genes
NOC4L	lof_high_possible_no_ch_genes
FAM186A	lof_high_possible_no_ch_genes
LRRK2	lof_high_possible_no_ch_genes
NCOR2	lof_high_possible_no_ch_genes
NACA	lof_high_possible_no_ch_genes
MFAP5	lof_high_possible_no_ch_genes
RASSF9	lof_high_possible_no_ch_genes
LRRC10	lof_high_possible_no_ch_genes
LRCOL1	lof_high_possible_no_ch_genes
KRT6A	lof_high_possible_no_ch_genes
MUC19	lof_high_possible_no_ch_genes
FBXL3	lof_high_possible_no_ch_genes
IFT88	lof_high_possible_no_ch_genes
FRY	lof_high_possible_no_ch_genes
HTR2A	lof_high_possible_no_ch_genes
DGKH	lof_high_possible_no_ch_genes
MEDAG	lof_high_possible_no_ch_genes
DNAJC15	lof_high_possible_no_ch_genes
ATP7B	lof_high_possible_no_ch_genes
XPO4	lof_high_possible_no_ch_genes
LMO7	lof_high_possible_no_ch_genes
SETDB2	lof_high_possible_no_ch_genes
SLC46A3	lof_high_possible_no_ch_genes
LNX2	lof_high_possible_no_ch_genes
BRCA2	lof_high_possible_no_ch_genes
ESD	lof_high_possible_no_ch_genes
FOXO1	lof_high_possible_no_ch_genes
SACS	lof_high_possible_no_ch_genes
CENPJ	lof_high_possible_no_ch_genes
MICU2	lof_high_possible_no_ch_genes
CBY2	lof_high_possible_no_ch_genes
ATP4B	lof_high_possible_no_ch_genes
NEK5	lof_high_possible_no_ch_genes
AL592490.1	lof_high_possible_no_ch_genes
PCDH20	lof_high_possible_no_ch_genes
ANGEL1	lof_high_possible_no_ch_genes
SPATA7	lof_high_possible_no_ch_genes
PTPN21	lof_high_possible_no_ch_genes
PSEN1	lof_high_possible_no_ch_genes
EXD2	lof_high_possible_no_ch_genes
CMA1	lof_high_possible_no_ch_genes
PPP2R3C	lof_high_possible_no_ch_genes
RPGRIP1	lof_high_possible_no_ch_genes
CEP170B	lof_high_possible_no_ch_genes
RBM23	lof_high_possible_no_ch_genes
PYGL	lof_high_possible_no_ch_genes
DAAM1	lof_high_possible_no_ch_genes
ISM2	lof_high_possible_no_ch_genes
CEP128	lof_high_possible_no_ch_genes
PSMC1	lof_high_possible_no_ch_genes
PAPLN	lof_high_possible_no_ch_genes
ACIN1	lof_high_possible_no_ch_genes
CHD8	lof_high_possible_no_ch_genes
DCAF4	lof_high_possible_no_ch_genes
VSX2	lof_high_possible_no_ch_genes
NEK9	lof_high_possible_no_ch_genes
NRDE2	lof_high_possible_no_ch_genes
BMP4	lof_high_possible_no_ch_genes
ADCY4	lof_high_possible_no_ch_genes
EAPP	lof_high_possible_no_ch_genes
ACTR10	lof_high_possible_no_ch_genes
CIDEB	lof_high_possible_no_ch_genes
NAA30	lof_high_possible_no_ch_genes
SLC24A4	lof_high_possible_no_ch_genes
MBIP	lof_high_possible_no_ch_genes
OXA1L	lof_high_possible_no_ch_genes
MIDEAS	lof_high_possible_no_ch_genes
DHRS4	lof_high_possible_no_ch_genes
CFL2	lof_high_possible_no_ch_genes
ASPG	lof_high_possible_no_ch_genes
PLD4	lof_high_possible_no_ch_genes
PTGDR	lof_high_possible_no_ch_genes
MGAT2	lof_high_possible_no_ch_genes
GPR137C	lof_high_possible_no_ch_genes
BTBD6	lof_high_possible_no_ch_genes
JAG2	lof_high_possible_no_ch_genes
BRF1	lof_high_possible_no_ch_genes
SERPINA3	lof_high_possible_no_ch_genes
NOP9	lof_high_possible_no_ch_genes
SLC25A29	lof_high_possible_no_ch_genes
CDC42BPB	lof_high_possible_no_ch_genes
AP1G2	lof_high_possible_no_ch_genes
HOMEZ	lof_high_possible_no_ch_genes
CHMP4A	lof_high_possible_no_ch_genes
AL136295.1	lof_high_possible_no_ch_genes
SPG21	lof_high_possible_no_ch_genes
TRPM7	lof_high_possible_no_ch_genes
CAPN3	lof_high_possible_no_ch_genes
IQCH	lof_high_possible_no_ch_genes
CEMIP	lof_high_possible_no_ch_genes
RPAP1	lof_high_possible_no_ch_genes
CEP152	lof_high_possible_no_ch_genes
TJP1	lof_high_possible_no_ch_genes
MYO5C	lof_high_possible_no_ch_genes
CALML4	lof_high_possible_no_ch_genes
THAP10	lof_high_possible_no_ch_genes
ADAMTS7	lof_high_possible_no_ch_genes
ALPK3	lof_high_possible_no_ch_genes
ITGA11	lof_high_possible_no_ch_genes
SMAD6	lof_high_possible_no_ch_genes
SLC28A2	lof_high_possible_no_ch_genes
USP8	lof_high_possible_no_ch_genes
SHF	lof_high_possible_no_ch_genes
NIPA2	lof_high_possible_no_ch_genes
ZSCAN29	lof_high_possible_no_ch_genes
BNIP2	lof_high_possible_no_ch_genes
MAN2C1	lof_high_possible_no_ch_genes
ARRDC4	lof_high_possible_no_ch_genes
ULK3	lof_high_possible_no_ch_genes
CYP1A2	lof_high_possible_no_ch_genes
MFGE8	lof_high_possible_no_ch_genes
CERS3	lof_high_possible_no_ch_genes
ADAMTSL3	lof_high_possible_no_ch_genes
WHAMM	lof_high_possible_no_ch_genes
RNF111	lof_high_possible_no_ch_genes
MYO1E	lof_high_possible_no_ch_genes
PPP1R14D	lof_high_possible_no_ch_genes
CATSPER2	lof_high_possible_no_ch_genes
PLIN1	lof_high_possible_no_ch_genes
EPB42	lof_high_possible_no_ch_genes
TERB2	lof_high_possible_no_ch_genes
ADAL	lof_high_possible_no_ch_genes
MINAR1	lof_high_possible_no_ch_genes
FOXB1	lof_high_possible_no_ch_genes
ARNT2	lof_high_possible_no_ch_genes
REC114	lof_high_possible_no_ch_genes
FAN1	lof_high_possible_no_ch_genes
GANC	lof_high_possible_no_ch_genes
KBTBD13	lof_high_possible_no_ch_genes
AGBL1	lof_high_possible_no_ch_genes
AC084756.2	lof_high_possible_no_ch_genes
RIPOR1	lof_high_possible_no_ch_genes
ACSM2B	lof_high_possible_no_ch_genes
SLC12A3	lof_high_possible_no_ch_genes
RGS11	lof_high_possible_no_ch_genes
PALB2	lof_high_possible_no_ch_genes
LPCAT2	lof_high_possible_no_ch_genes
TNRC6A	lof_high_possible_no_ch_genes
MAPK3	lof_high_possible_no_ch_genes
NUP93	lof_high_possible_no_ch_genes
TSNAXIP1	lof_high_possible_no_ch_genes
NDRG4	lof_high_possible_no_ch_genes
SETD6	lof_high_possible_no_ch_genes
HAS3	lof_high_possible_no_ch_genes
NME4	lof_high_possible_no_ch_genes
SLC7A5	lof_high_possible_no_ch_genes
PRSS33	lof_high_possible_no_ch_genes
RPGRIP1L	lof_high_possible_no_ch_genes
RNF40	lof_high_possible_no_ch_genes
SLC12A4	lof_high_possible_no_ch_genes
GFER	lof_high_possible_no_ch_genes
PKMYT1	lof_high_possible_no_ch_genes
ERN2	lof_high_possible_no_ch_genes
KIAA0513	lof_high_possible_no_ch_genes
ZFHX3	lof_high_possible_no_ch_genes
ADAMTS18	lof_high_possible_no_ch_genes
NOB1	lof_high_possible_no_ch_genes
TBX6	lof_high_possible_no_ch_genes
TLCD3B	lof_high_possible_no_ch_genes
DOC2A	lof_high_possible_no_ch_genes
TXNDC11	lof_high_possible_no_ch_genes
CMIP	lof_high_possible_no_ch_genes
FBRS	lof_high_possible_no_ch_genes
ITGAD	lof_high_possible_no_ch_genes
FCSK	lof_high_possible_no_ch_genes
ZDHHC1	lof_high_possible_no_ch_genes
HS3ST6	lof_high_possible_no_ch_genes
BICDL2	lof_high_possible_no_ch_genes
CDH16	lof_high_possible_no_ch_genes
DPEP2	lof_high_possible_no_ch_genes
MVD	lof_high_possible_no_ch_genes
CDT1	lof_high_possible_no_ch_genes
ABCA3	lof_high_possible_no_ch_genes
SRRM2	lof_high_possible_no_ch_genes
MLKL	lof_high_possible_no_ch_genes
UMOD	lof_high_possible_no_ch_genes
ITGAM	lof_high_possible_no_ch_genes
SHCBP1	lof_high_possible_no_ch_genes
VAT1L	lof_high_possible_no_ch_genes
CES2	lof_high_possible_no_ch_genes
PRSS36	lof_high_possible_no_ch_genes
ZFP90	lof_high_possible_no_ch_genes
PDIA2	lof_high_possible_no_ch_genes
ZNF267	lof_high_possible_no_ch_genes
SLX4	lof_high_possible_no_ch_genes
ERI2	lof_high_possible_no_ch_genes
METTL9	lof_high_possible_no_ch_genes
CES1	lof_high_possible_no_ch_genes
C16orf96	lof_high_possible_no_ch_genes
PTX4	lof_high_possible_no_ch_genes
HP	lof_high_possible_no_ch_genes
SMIM22	lof_high_possible_no_ch_genes
PAGR1	lof_high_possible_no_ch_genes
LASP1	lof_high_possible_no_ch_genes
KIAA0100	lof_high_possible_no_ch_genes
SCN4A	lof_high_possible_no_ch_genes
NME1-NME2	lof_high_possible_no_ch_genes
UTP18	lof_high_possible_no_ch_genes
SMG6	lof_high_possible_no_ch_genes
ST6GALNAC1	lof_high_possible_no_ch_genes
ST6GALNAC2	lof_high_possible_no_ch_genes
SCARF1	lof_high_possible_no_ch_genes
ZZEF1	lof_high_possible_no_ch_genes
ITGAE	lof_high_possible_no_ch_genes
APOH	lof_high_possible_no_ch_genes
UNC13D	lof_high_possible_no_ch_genes
KRT23	lof_high_possible_no_ch_genes
CRYBA1	lof_high_possible_no_ch_genes
RUNDC3A	lof_high_possible_no_ch_genes
RAD51C	lof_high_possible_no_ch_genes
KRT37	lof_high_possible_no_ch_genes
CDK5RAP3	lof_high_possible_no_ch_genes
INTS2	lof_high_possible_no_ch_genes
DHX58	lof_high_possible_no_ch_genes
KAT2A	lof_high_possible_no_ch_genes
CNTNAP1	lof_high_possible_no_ch_genes
ALOX12	lof_high_possible_no_ch_genes
MED1	lof_high_possible_no_ch_genes
WNK4	lof_high_possible_no_ch_genes
METTL16	lof_high_possible_no_ch_genes
USP6	lof_high_possible_no_ch_genes
QRICH2	lof_high_possible_no_ch_genes
RHBDF2	lof_high_possible_no_ch_genes
TNS4	lof_high_possible_no_ch_genes
TOP2A	lof_high_possible_no_ch_genes
SERPINF1	lof_high_possible_no_ch_genes
TRIM47	lof_high_possible_no_ch_genes
PTRH2	lof_high_possible_no_ch_genes
MINK1	lof_high_possible_no_ch_genes
CCDC40	lof_high_possible_no_ch_genes
CARD14	lof_high_possible_no_ch_genes
TRIM65	lof_high_possible_no_ch_genes
CEP131	lof_high_possible_no_ch_genes
STAC2	lof_high_possible_no_ch_genes
ANKFN1	lof_high_possible_no_ch_genes
ABCA5	lof_high_possible_no_ch_genes
CXCL16	lof_high_possible_no_ch_genes
CCDC182	lof_high_possible_no_ch_genes
ENGASE	lof_high_possible_no_ch_genes
SMG8	lof_high_possible_no_ch_genes
FASN	lof_high_possible_no_ch_genes
KRT19	lof_high_possible_no_ch_genes
KRT20	lof_high_possible_no_ch_genes
BPTF	lof_high_possible_no_ch_genes
SLFN12	lof_high_possible_no_ch_genes
RAB37	lof_high_possible_no_ch_genes
JUP	lof_high_possible_no_ch_genes
RNF213	lof_high_possible_no_ch_genes
KRT28	lof_high_possible_no_ch_genes
PPM1E	lof_high_possible_no_ch_genes
MYO1D	lof_high_possible_no_ch_genes
ALOX15B	lof_high_possible_no_ch_genes
MEIOC	lof_high_possible_no_ch_genes
ZFP3	lof_high_possible_no_ch_genes
CUEDC1	lof_high_possible_no_ch_genes
AATK	lof_high_possible_no_ch_genes
USH1G	lof_high_possible_no_ch_genes
TSEN54	lof_high_possible_no_ch_genes
MXRA7	lof_high_possible_no_ch_genes
GALR2	lof_high_possible_no_ch_genes
OTOP3	lof_high_possible_no_ch_genes
DNAH2	lof_high_possible_no_ch_genes
SPPL2C	lof_high_possible_no_ch_genes
CCDC137	lof_high_possible_no_ch_genes
RAD51D	lof_high_possible_no_ch_genes
KIF18B	lof_high_possible_no_ch_genes
KRT26	lof_high_possible_no_ch_genes
C17orf58	lof_high_possible_no_ch_genes
KRT14	lof_high_possible_no_ch_genes
KRTAP17-1	lof_high_possible_no_ch_genes
KRTAP9-8	lof_high_possible_no_ch_genes
SIRT7	lof_high_possible_no_ch_genes
FBF1	lof_high_possible_no_ch_genes
SHPK	lof_high_possible_no_ch_genes
CSHL1	lof_high_possible_no_ch_genes
KRT40	lof_high_possible_no_ch_genes
KRT25	lof_high_possible_no_ch_genes
TRIM16	lof_high_possible_no_ch_genes
NME2	lof_high_possible_no_ch_genes
AC005324.3	lof_high_possible_no_ch_genes
GH1	lof_high_possible_no_ch_genes
AC004223.3	lof_high_possible_no_ch_genes
RASL10B	lof_high_possible_no_ch_genes
RDM1	lof_high_possible_no_ch_genes
GGNBP2	lof_high_possible_no_ch_genes
AC127029.3	lof_high_possible_no_ch_genes
LAMA3	lof_high_possible_no_ch_genes
LMAN1	lof_high_possible_no_ch_genes
NDC80	lof_high_possible_no_ch_genes
ATP8B1	lof_high_possible_no_ch_genes
ST8SIA5	lof_high_possible_no_ch_genes
POLI	lof_high_possible_no_ch_genes
RBBP8	lof_high_possible_no_ch_genes
RIOK3	lof_high_possible_no_ch_genes
TTR	lof_high_possible_no_ch_genes
NFATC1	lof_high_possible_no_ch_genes
EMILIN2	lof_high_possible_no_ch_genes
DSG3	lof_high_possible_no_ch_genes
GREB1L	lof_high_possible_no_ch_genes
PPP4R1	lof_high_possible_no_ch_genes
CCDC178	lof_high_possible_no_ch_genes
HDHD2	lof_high_possible_no_ch_genes
SIGLEC15	lof_high_possible_no_ch_genes
C18orf63	lof_high_possible_no_ch_genes
FUZ	lof_high_possible_no_ch_genes
WIZ	lof_high_possible_no_ch_genes
CD22	lof_high_possible_no_ch_genes
NLRP2	lof_high_possible_no_ch_genes
PNPLA6	lof_high_possible_no_ch_genes
PNKP	lof_high_possible_no_ch_genes
HOMER3	lof_high_possible_no_ch_genes
GPATCH1	lof_high_possible_no_ch_genes
COL5A3	lof_high_possible_no_ch_genes
CNOT3	lof_high_possible_no_ch_genes
PLEKHG2	lof_high_possible_no_ch_genes
HOOK2	lof_high_possible_no_ch_genes
MAST3	lof_high_possible_no_ch_genes
CBARP	lof_high_possible_no_ch_genes
TULP2	lof_high_possible_no_ch_genes
TRMT1	lof_high_possible_no_ch_genes
AKAP8	lof_high_possible_no_ch_genes
ILVBL	lof_high_possible_no_ch_genes
SYDE1	lof_high_possible_no_ch_genes
ANKRD27	lof_high_possible_no_ch_genes
TIMM50	lof_high_possible_no_ch_genes
DYRK1B	lof_high_possible_no_ch_genes
APLP1	lof_high_possible_no_ch_genes
TGFB1	lof_high_possible_no_ch_genes
NOP53	lof_high_possible_no_ch_genes
CD33	lof_high_possible_no_ch_genes
CEACAM5	lof_high_possible_no_ch_genes
MEIS3	lof_high_possible_no_ch_genes
GRIN2D	lof_high_possible_no_ch_genes
LILRB5	lof_high_possible_no_ch_genes
PDE4C	lof_high_possible_no_ch_genes
SUGP1	lof_high_possible_no_ch_genes
PCSK4	lof_high_possible_no_ch_genes
GRIN3B	lof_high_possible_no_ch_genes
B9D2	lof_high_possible_no_ch_genes
KIR2DL1	lof_high_possible_no_ch_genes
SH2D3A	lof_high_possible_no_ch_genes
EML2	lof_high_possible_no_ch_genes
KRI1	lof_high_possible_no_ch_genes
SLC44A2	lof_high_possible_no_ch_genes
KLK10	lof_high_possible_no_ch_genes
SHC2	lof_high_possible_no_ch_genes
BST2	lof_high_possible_no_ch_genes
ATG4D	lof_high_possible_no_ch_genes
ZC3H4	lof_high_possible_no_ch_genes
NAPSA	lof_high_possible_no_ch_genes
ZSWIM4	lof_high_possible_no_ch_genes
NFIC	lof_high_possible_no_ch_genes
TPGS1	lof_high_possible_no_ch_genes
DUS3L	lof_high_possible_no_ch_genes
LMTK3	lof_high_possible_no_ch_genes
WTIP	lof_high_possible_no_ch_genes
CPAMD8	lof_high_possible_no_ch_genes
SHKBP1	lof_high_possible_no_ch_genes
RDH13	lof_high_possible_no_ch_genes
ZNF333	lof_high_possible_no_ch_genes
CCDC105	lof_high_possible_no_ch_genes
MFSD12	lof_high_possible_no_ch_genes
U2AF1L4	lof_high_possible_no_ch_genes
THAP8	lof_high_possible_no_ch_genes
TMEM143	lof_high_possible_no_ch_genes
KASH5	lof_high_possible_no_ch_genes
NIBAN3	lof_high_possible_no_ch_genes
TMC4	lof_high_possible_no_ch_genes
ZNF526	lof_high_possible_no_ch_genes
DNAAF3	lof_high_possible_no_ch_genes
DAPK3	lof_high_possible_no_ch_genes
ATF5	lof_high_possible_no_ch_genes
RLN3	lof_high_possible_no_ch_genes
ZNF439	lof_high_possible_no_ch_genes
ZNF57	lof_high_possible_no_ch_genes
PCP2	lof_high_possible_no_ch_genes
MYPOP	lof_high_possible_no_ch_genes
ZNF575	lof_high_possible_no_ch_genes
PHLDB3	lof_high_possible_no_ch_genes
C19orf18	lof_high_possible_no_ch_genes
SIX5	lof_high_possible_no_ch_genes
GGN	lof_high_possible_no_ch_genes
SYCN	lof_high_possible_no_ch_genes
NLRP11	lof_high_possible_no_ch_genes
ZNF154	lof_high_possible_no_ch_genes
ARHGAP45	lof_high_possible_no_ch_genes
ZNF571	lof_high_possible_no_ch_genes
ZSCAN4	lof_high_possible_no_ch_genes
CAPN12	lof_high_possible_no_ch_genes
ZNF93	lof_high_possible_no_ch_genes
NLRP9	lof_high_possible_no_ch_genes
ZNF829	lof_high_possible_no_ch_genes
RGS9BP	lof_high_possible_no_ch_genes
CYP4F3	lof_high_possible_no_ch_genes
VSIG10L	lof_high_possible_no_ch_genes
EPOR	lof_high_possible_no_ch_genes
HAPLN4	lof_high_possible_no_ch_genes
ZNF559	lof_high_possible_no_ch_genes
SBSN	lof_high_possible_no_ch_genes
ZNF569	lof_high_possible_no_ch_genes
ZNF429	lof_high_possible_no_ch_genes
ZNF441	lof_high_possible_no_ch_genes
CYP2B6	lof_high_possible_no_ch_genes
CYP2A13	lof_high_possible_no_ch_genes
ZNF607	lof_high_possible_no_ch_genes
TEX45	lof_high_possible_no_ch_genes
LILRB3	lof_high_possible_no_ch_genes
PSG5	lof_high_possible_no_ch_genes
ONECUT3	lof_high_possible_no_ch_genes
ZNF726	lof_high_possible_no_ch_genes
PSG2	lof_high_possible_no_ch_genes
ZNF350	lof_high_possible_no_ch_genes
IFNL4	lof_high_possible_no_ch_genes
AC008397.2	lof_high_possible_no_ch_genes
RIPOR3	lof_high_possible_no_ch_genes
BCAS1	lof_high_possible_no_ch_genes
CST7	lof_high_possible_no_ch_genes
CBFA2T2	lof_high_possible_no_ch_genes
LZTS3	lof_high_possible_no_ch_genes
KIZ	lof_high_possible_no_ch_genes
ESF1	lof_high_possible_no_ch_genes
CFAP61	lof_high_possible_no_ch_genes
TRMT6	lof_high_possible_no_ch_genes
SGK2	lof_high_possible_no_ch_genes
IFT52	lof_high_possible_no_ch_genes
SALL4	lof_high_possible_no_ch_genes
SLC17A9	lof_high_possible_no_ch_genes
PTK6	lof_high_possible_no_ch_genes
FERMT1	lof_high_possible_no_ch_genes
SAMHD1	lof_high_possible_no_ch_genes
PAK5	lof_high_possible_no_ch_genes
MAPRE1	lof_high_possible_no_ch_genes
PXMP4	lof_high_possible_no_ch_genes
GCNT7	lof_high_possible_no_ch_genes
CTCFL	lof_high_possible_no_ch_genes
SNX21	lof_high_possible_no_ch_genes
ARFGEF2	lof_high_possible_no_ch_genes
ZNFX1	lof_high_possible_no_ch_genes
PTGIS	lof_high_possible_no_ch_genes
CDH26	lof_high_possible_no_ch_genes
C20orf85	lof_high_possible_no_ch_genes
PAX1	lof_high_possible_no_ch_genes
MKKS	lof_high_possible_no_ch_genes
BPIFB1	lof_high_possible_no_ch_genes
CEP250	lof_high_possible_no_ch_genes
HELZ2	lof_high_possible_no_ch_genes
GATA5	lof_high_possible_no_ch_genes
LAMA5	lof_high_possible_no_ch_genes
BPIFA3	lof_high_possible_no_ch_genes
PCED1A	lof_high_possible_no_ch_genes
CNBD2	lof_high_possible_no_ch_genes
SPINT4	lof_high_possible_no_ch_genes
TGM6	lof_high_possible_no_ch_genes
ZSWIM1	lof_high_possible_no_ch_genes
NANP	lof_high_possible_no_ch_genes
L3MBTL1	lof_high_possible_no_ch_genes
STMN3	lof_high_possible_no_ch_genes
ZNF335	lof_high_possible_no_ch_genes
UCKL1	lof_high_possible_no_ch_genes
EFCAB8	lof_high_possible_no_ch_genes
RBM12	lof_high_possible_no_ch_genes
AL031681.3	lof_high_possible_no_ch_genes
COL6A2	lof_high_possible_no_ch_genes
ADAMTS5	lof_high_possible_no_ch_genes
HSPA13	lof_high_possible_no_ch_genes
USP16	lof_high_possible_no_ch_genes
BACH1	lof_high_possible_no_ch_genes
ERG	lof_high_possible_no_ch_genes
LCA5L	lof_high_possible_no_ch_genes
CFAP298	lof_high_possible_no_ch_genes
RUNX1	lof_high_possible_no_ch_genes
UBASH3A	lof_high_possible_no_ch_genes
PDE9A	lof_high_possible_no_ch_genes
LRRC3	lof_high_possible_no_ch_genes
GRIK1	lof_high_possible_no_ch_genes
ZBTB21	lof_high_possible_no_ch_genes
COL18A1	lof_high_possible_no_ch_genes
IGSF5	lof_high_possible_no_ch_genes
BRWD1	lof_high_possible_no_ch_genes
SETD4	lof_high_possible_no_ch_genes
LTN1	lof_high_possible_no_ch_genes
CFAP298-TCP10L	lof_high_possible_no_ch_genes
BID	lof_high_possible_no_ch_genes
CLTCL1	lof_high_possible_no_ch_genes
SELENOO	lof_high_possible_no_ch_genes
COMT	lof_high_possible_no_ch_genes
MMP11	lof_high_possible_no_ch_genes
P2RX6	lof_high_possible_no_ch_genes
PES1	lof_high_possible_no_ch_genes
SRRD	lof_high_possible_no_ch_genes
TFIP11	lof_high_possible_no_ch_genes
SLC5A1	lof_high_possible_no_ch_genes
SLC5A4	lof_high_possible_no_ch_genes
CYP2D6	lof_high_possible_no_ch_genes
TCF20	lof_high_possible_no_ch_genes
FBXO7	lof_high_possible_no_ch_genes
HMOX1	lof_high_possible_no_ch_genes
TTLL12	lof_high_possible_no_ch_genes
PNPLA3	lof_high_possible_no_ch_genes
FOXRED2	lof_high_possible_no_ch_genes
TUBGCP6	lof_high_possible_no_ch_genes
BAIAP2L2	lof_high_possible_no_ch_genes
TTLL8	lof_high_possible_no_ch_genes
RGL4	lof_high_possible_no_ch_genes
VPREB1	lof_high_possible_no_ch_genes
PRR14L	lof_high_possible_no_ch_genes
KREMEN1	lof_high_possible_no_ch_genes
NDUFA6	lof_high_possible_no_ch_genes
INPP5J	lof_high_possible_no_ch_genes
TMPRSS6	lof_high_possible_no_ch_genes
CRYBA4	lof_high_possible_no_ch_genes
PLXNB2	lof_high_possible_no_ch_genes
CPT1B	lof_high_possible_no_ch_genes
CCDC188	lof_high_possible_no_ch_genes
MIF	lof_high_possible_no_ch_genes
SCARF2	lof_high_possible_no_ch_genes
ZNF280B	lof_high_possible_no_ch_genes
NIPAL3	rand_ch_genes
TTC22	rand_ch_genes
MASP2	rand_ch_genes
TRAF3IP3	rand_ch_genes
CLCN6	rand_ch_genes
MTMR11	rand_ch_genes
USH2A	rand_ch_genes
H6PD	rand_ch_genes
TARBP1	rand_ch_genes
SPEN	rand_ch_genes
PACC1	rand_ch_genes
ASPM	rand_ch_genes
EVI5	rand_ch_genes
PLXNA2	rand_ch_genes
GPR137B	rand_ch_genes
COL16A1	rand_ch_genes
OVGP1	rand_ch_genes
MUL1	rand_ch_genes
BCL9	rand_ch_genes
DNAJC16	rand_ch_genes
LRRC42	rand_ch_genes
NPHS2	rand_ch_genes
STXBP3	rand_ch_genes
ELAPOR1	rand_ch_genes
ASH1L	rand_ch_genes
PRG4	rand_ch_genes
RO60	rand_ch_genes
TNNI3K	rand_ch_genes
PLEKHM2	rand_ch_genes
TTF2	rand_ch_genes
HAO2	rand_ch_genes
ZP4	rand_ch_genes
ST6GALNAC5	rand_ch_genes
GBP1	rand_ch_genes
CDK18	rand_ch_genes
CR2	rand_ch_genes
PTCH2	rand_ch_genes
AKR1A1	rand_ch_genes
TMED5	rand_ch_genes
PRRC2C	rand_ch_genes
DARS2	rand_ch_genes
RCOR3	rand_ch_genes
ATF6	rand_ch_genes
RAB3GAP2	rand_ch_genes
TRIM67	rand_ch_genes
HEATR1	rand_ch_genes
ECHDC2	rand_ch_genes
RGSL1	rand_ch_genes
LRIF1	rand_ch_genes
ODF2L	rand_ch_genes
AUNIP	rand_ch_genes
HP1BP3	rand_ch_genes
PPT1	rand_ch_genes
NPHP4	rand_ch_genes
CHD1L	rand_ch_genes
FMO5	rand_ch_genes
PRKAB2	rand_ch_genes
SPATA6	rand_ch_genes
ATP1A4	rand_ch_genes
DPH2	rand_ch_genes
MUTYH	rand_ch_genes
GSTM3	rand_ch_genes
CHIA	rand_ch_genes
HMGCS2	rand_ch_genes
NOTCH2	rand_ch_genes
NAV1	rand_ch_genes
HOOK1	rand_ch_genes
PCNX2	rand_ch_genes
CAPN9	rand_ch_genes
PIGC	rand_ch_genes
TTLL7	rand_ch_genes
BRDT	rand_ch_genes
RABGGTB	rand_ch_genes
SLC44A5	rand_ch_genes
CLCA2	rand_ch_genes
MMEL1	rand_ch_genes
CFAP74	rand_ch_genes
FHAD1	rand_ch_genes
CNKSR1	rand_ch_genes
EVA1B	rand_ch_genes
HSPG2	rand_ch_genes
CYP4B1	rand_ch_genes
IGSF3	rand_ch_genes
FNDC7	rand_ch_genes
ADCY10	rand_ch_genes
CASQ1	rand_ch_genes
TOR1AIP1	rand_ch_genes
ECM1	rand_ch_genes
CGN	rand_ch_genes
DTL	rand_ch_genes
TAF1A	rand_ch_genes
HHIPL2	rand_ch_genes
ADAM15	rand_ch_genes
SNAPIN	rand_ch_genes
SLC39A1	rand_ch_genes
INTS3	rand_ch_genes
PKLR	rand_ch_genes
C1orf131	rand_ch_genes
GALNT2	rand_ch_genes
CNIH3	rand_ch_genes
C1orf35	rand_ch_genes
OBSCN	rand_ch_genes
SHCBP1L	rand_ch_genes
SKI	rand_ch_genes
PAFAH2	rand_ch_genes
GRHL3	rand_ch_genes
ELK4	rand_ch_genes
SLC45A3	rand_ch_genes
NBL1	rand_ch_genes
VWA5B1	rand_ch_genes
LAD1	rand_ch_genes
CCDC17	rand_ch_genes
IL6R	rand_ch_genes
CHRNB2	rand_ch_genes
CMPK1	rand_ch_genes
TMCO4	rand_ch_genes
MEGF6	rand_ch_genes
CCDC27	rand_ch_genes
HFM1	rand_ch_genes
BROX	rand_ch_genes
WDR64	rand_ch_genes
KIF26B	rand_ch_genes
FCMR	rand_ch_genes
PIGR	rand_ch_genes
CAPN2	rand_ch_genes
VPS72	rand_ch_genes
IGFN1	rand_ch_genes
MNDA	rand_ch_genes
C1orf50	rand_ch_genes
SERINC2	rand_ch_genes
PCSK9	rand_ch_genes
EFNA1	rand_ch_genes
LUZP1	rand_ch_genes
PLEKHG5	rand_ch_genes
SLFNL1	rand_ch_genes
METTL18	rand_ch_genes
ANGPTL7	rand_ch_genes
SELP	rand_ch_genes
SH3BP5L	rand_ch_genes
RNPEP	rand_ch_genes
MTHFR	rand_ch_genes
TMEM125	rand_ch_genes
HTR1D	rand_ch_genes
SELENOF	rand_ch_genes
H3C13	rand_ch_genes
C1QTNF12	rand_ch_genes
TACSTD2	rand_ch_genes
CLCNKB	rand_ch_genes
SMYD3	rand_ch_genes
AGBL4	rand_ch_genes
CYP4Z1	rand_ch_genes
CYP4X1	rand_ch_genes
CLCNKA	rand_ch_genes
FOXD2	rand_ch_genes
ESPN	rand_ch_genes
FOXD3	rand_ch_genes
KLHL17	rand_ch_genes
RAB42	rand_ch_genes
S100A4	rand_ch_genes
SEMA4A	rand_ch_genes
MIB2	rand_ch_genes
HHLA3	rand_ch_genes
ANKRD35	rand_ch_genes
EFCAB7	rand_ch_genes
PRAMEF17	rand_ch_genes
DISP3	rand_ch_genes
RBMXL1	rand_ch_genes
CYB5RL	rand_ch_genes
C1orf167	rand_ch_genes
NBPF1	rand_ch_genes
ANKRD65	rand_ch_genes
KIAA0040	rand_ch_genes
BGLAP	rand_ch_genes
FPGT-TNNI3K	rand_ch_genes
PRAMEF18	rand_ch_genes
GCFC2	rand_ch_genes
SLC11A1	rand_ch_genes
CAPG	rand_ch_genes
LY75	rand_ch_genes
PUM2	rand_ch_genes
PMS1	rand_ch_genes
STON1-GTF2A1L	rand_ch_genes
SRBD1	rand_ch_genes
MYO3B	rand_ch_genes
PTPN18	rand_ch_genes
SPEG	rand_ch_genes
ABCB11	rand_ch_genes
DNAJC10	rand_ch_genes
MPP4	rand_ch_genes
APOB	rand_ch_genes
USP40	rand_ch_genes
FAHD2A	rand_ch_genes
GPD2	rand_ch_genes
IFIH1	rand_ch_genes
GCA	rand_ch_genes
GALNT3	rand_ch_genes
CCDC88A	rand_ch_genes
FN1	rand_ch_genes
DNAH6	rand_ch_genes
PECR	rand_ch_genes
IGFBP2	rand_ch_genes
ABCB6	rand_ch_genes
PASK	rand_ch_genes
TAF1B	rand_ch_genes
NOL10	rand_ch_genes
GORASP2	rand_ch_genes
CEBPZ	rand_ch_genes
LCT	rand_ch_genes
EPHA4	rand_ch_genes
ALMS1	rand_ch_genes
DNAH7	rand_ch_genes
CYP20A1	rand_ch_genes
NCAPH	rand_ch_genes
HJURP	rand_ch_genes
METTL8	rand_ch_genes
TTC21B	rand_ch_genes
OBSL1	rand_ch_genes
VIL1	rand_ch_genes
HOXD1	rand_ch_genes
MTX2	rand_ch_genes
PDE11A	rand_ch_genes
OSGEPL1	rand_ch_genes
HOXD13	rand_ch_genes
SAG	rand_ch_genes
PER2	rand_ch_genes
RAMP1	rand_ch_genes
EGR4	rand_ch_genes
DYSF	rand_ch_genes
TTLL4	rand_ch_genes
WNT10A	rand_ch_genes
GALNT5	rand_ch_genes
SMPD4	rand_ch_genes
UGGT1	rand_ch_genes
CYP1B1	rand_ch_genes
TRIM54	rand_ch_genes
ATIC	rand_ch_genes
BARD1	rand_ch_genes
FASTKD1	rand_ch_genes
MDH1B	rand_ch_genes
WDR12	rand_ch_genes
ABI2	rand_ch_genes
ITGAV	rand_ch_genes
GDF7	rand_ch_genes
CAMKMT	rand_ch_genes
PKP4	rand_ch_genes
UNC80	rand_ch_genes
NBEAL1	rand_ch_genes
KANSL1L	rand_ch_genes
NYAP2	rand_ch_genes
ANKMY1	rand_ch_genes
ALLC	rand_ch_genes
ANKAR	rand_ch_genes
MFSD6	rand_ch_genes
G6PC2	rand_ch_genes
BOLL	rand_ch_genes
PLEKHH2	rand_ch_genes
RASGRP3	rand_ch_genes
ANAPC1	rand_ch_genes
RGPD3	rand_ch_genes
ATP5MC3	rand_ch_genes
CNTNAP5	rand_ch_genes
TTN	rand_ch_genes
DRC1	rand_ch_genes
XDH	rand_ch_genes
EIF5B	rand_ch_genes
PKDCC	rand_ch_genes
TYW5	rand_ch_genes
SLC16A14	rand_ch_genes
TEKT4	rand_ch_genes
BBS5	rand_ch_genes
TMEM169	rand_ch_genes
GLB1L	rand_ch_genes
ICA1L	rand_ch_genes
PLB1	rand_ch_genes
KIF5C	rand_ch_genes
E2F6	rand_ch_genes
SCN9A	rand_ch_genes
APLF	rand_ch_genes
BUB1	rand_ch_genes
LIMS1	rand_ch_genes
HOXD12	rand_ch_genes
FAM161A	rand_ch_genes
FEZ2	rand_ch_genes
ALK	rand_ch_genes
ECEL1	rand_ch_genes
REG1B	rand_ch_genes
UBXN2A	rand_ch_genes
NCKAP5	rand_ch_genes
RBM44	rand_ch_genes
PLEKHM3	rand_ch_genes
ASB18	rand_ch_genes
NEB	rand_ch_genes
FOXD4L1	rand_ch_genes
FAM110C	rand_ch_genes
MROH2A	rand_ch_genes
SEPTIN10	rand_ch_genes
SESTD1	rand_ch_genes
CERKL	rand_ch_genes
SLC4A5	rand_ch_genes
FSIP2	rand_ch_genes
WDSUB1	rand_ch_genes
RFX8	rand_ch_genes
TTC30B	rand_ch_genes
RGPD4	rand_ch_genes
SULT1C2	rand_ch_genes
SPRED2	rand_ch_genes
CDKL4	rand_ch_genes
RAD51AP2	rand_ch_genes
SP9	rand_ch_genes
CROCC2	rand_ch_genes
DYTN	rand_ch_genes
FAM237A	rand_ch_genes
STPG4	rand_ch_genes
UGT1A3	rand_ch_genes
STON1	rand_ch_genes
LY75-CD302	rand_ch_genes
AC093899.2	rand_ch_genes
PPP4R3B	rand_ch_genes
RBM5	rand_ch_genes
CELSR3	rand_ch_genes
LTF	rand_ch_genes
ASTE1	rand_ch_genes
POLQ	rand_ch_genes
ITIH1	rand_ch_genes
DCBLD2	rand_ch_genes
TNK2	rand_ch_genes
PPP2R3A	rand_ch_genes
ST6GAL1	rand_ch_genes
LXN	rand_ch_genes
KIF9	rand_ch_genes
CDV3	rand_ch_genes
EHHADH	rand_ch_genes
OGG1	rand_ch_genes
PCCB	rand_ch_genes
CEP70	rand_ch_genes
GRK7	rand_ch_genes
XRN1	rand_ch_genes
SERPINI2	rand_ch_genes
GNB4	rand_ch_genes
FRMD4B	rand_ch_genes
EFCC1	rand_ch_genes
CISH	rand_ch_genes
DNAH1	rand_ch_genes
EIF4G1	rand_ch_genes
PDZRN3	rand_ch_genes
SEC22A	rand_ch_genes
TNFSF10	rand_ch_genes
MBD4	rand_ch_genes
RBSN	rand_ch_genes
IRAK2	rand_ch_genes
CNTN6	rand_ch_genes
SLC25A26	rand_ch_genes
NXPE3	rand_ch_genes
MYH15	rand_ch_genes
BOC	rand_ch_genes
TMEM44	rand_ch_genes
MUC4	rand_ch_genes
ECE2	rand_ch_genes
NGLY1	rand_ch_genes
QTRT2	rand_ch_genes
ABI3BP	rand_ch_genes
KLHL40	rand_ch_genes
DZIP1L	rand_ch_genes
ESYT3	rand_ch_genes
FAIM	rand_ch_genes
MYL3	rand_ch_genes
FBLN2	rand_ch_genes
CLASP2	rand_ch_genes
CD200R1	rand_ch_genes
SPICE1	rand_ch_genes
ATXN7	rand_ch_genes
PRICKLE2	rand_ch_genes
ERICH6	rand_ch_genes
PTX3	rand_ch_genes
IL17RE	rand_ch_genes
GYG1	rand_ch_genes
HPS3	rand_ch_genes
RYK	rand_ch_genes
KIF15	rand_ch_genes
FYCO1	rand_ch_genes
DTX3L	rand_ch_genes
YEATS2	rand_ch_genes
IFT122	rand_ch_genes
TKT	rand_ch_genes
PLXNB1	rand_ch_genes
ATRIP	rand_ch_genes
MST1R	rand_ch_genes
SCN11A	rand_ch_genes
HSPBAP1	rand_ch_genes
BTD	rand_ch_genes
RIOX2	rand_ch_genes
SUCLG2	rand_ch_genes
COL6A5	rand_ch_genes
PARP15	rand_ch_genes
RSRC1	rand_ch_genes
DHX36	rand_ch_genes
ZIC4	rand_ch_genes
ATR	rand_ch_genes
ZNF654	rand_ch_genes
GPR156	rand_ch_genes
USF3	rand_ch_genes
ALS2CL	rand_ch_genes
GRAMD1C	rand_ch_genes
C3orf38	rand_ch_genes
HCLS1	rand_ch_genes
HMCES	rand_ch_genes
TRAIP	rand_ch_genes
SCN10A	rand_ch_genes
ZNF501	rand_ch_genes
ATP13A5	rand_ch_genes
TPRG1	rand_ch_genes
ZKSCAN7	rand_ch_genes
PIK3R4	rand_ch_genes
VEPH1	rand_ch_genes
CD200R1L	rand_ch_genes
TREX1	rand_ch_genes
SPINK8	rand_ch_genes
GPX1	rand_ch_genes
CCDC13	rand_ch_genes
TMEM158	rand_ch_genes
AC006059.2	rand_ch_genes
CCDC39	rand_ch_genes
EEF1AKMT4-ECE2	rand_ch_genes
LAP3	rand_ch_genes
CD38	rand_ch_genes
UBA6	rand_ch_genes
FAM184B	rand_ch_genes
CC2D2A	rand_ch_genes
FNIP2	rand_ch_genes
TXK	rand_ch_genes
N4BP2	rand_ch_genes
CRACD	rand_ch_genes
NFKB1	rand_ch_genes
AREG	rand_ch_genes
ELF2	rand_ch_genes
SEPSECS	rand_ch_genes
SLC2A9	rand_ch_genes
MFSD10	rand_ch_genes
BST1	rand_ch_genes
SPP1	rand_ch_genes
SH3TC1	rand_ch_genes
PAICS	rand_ch_genes
POLN	rand_ch_genes
KLB	rand_ch_genes
UGT2B28	rand_ch_genes
CPEB2	rand_ch_genes
TTC29	rand_ch_genes
HERC5	rand_ch_genes
ZGRF1	rand_ch_genes
MMRN1	rand_ch_genes
PDE5A	rand_ch_genes
TRPC3	rand_ch_genes
FRAS1	rand_ch_genes
PPA2	rand_ch_genes
PYURF	rand_ch_genes
RNF175	rand_ch_genes
MMAA	rand_ch_genes
TDO2	rand_ch_genes
DMP1	rand_ch_genes
ADGRA3	rand_ch_genes
UGT2B4	rand_ch_genes
AASDH	rand_ch_genes
SPON2	rand_ch_genes
HPGDS	rand_ch_genes
GNPDA2	rand_ch_genes
C4orf36	rand_ch_genes
AIMP1	rand_ch_genes
INTU	rand_ch_genes
C4orf3	rand_ch_genes
OTUD4	rand_ch_genes
TET2	rand_ch_genes
ZBTB49	rand_ch_genes
SLC49A3	rand_ch_genes
USP38	rand_ch_genes
NUDT6	rand_ch_genes
UGT2A1	rand_ch_genes
LARP7	rand_ch_genes
SRP72	rand_ch_genes
ODAPH	rand_ch_genes
DDX60L	rand_ch_genes
FREM3	rand_ch_genes
CCSER1	rand_ch_genes
NPY2R	rand_ch_genes
DEFB131A	rand_ch_genes
SOWAHB	rand_ch_genes
QRFPR	rand_ch_genes
ADH7	rand_ch_genes
DTHD1	rand_ch_genes
DCHS2	rand_ch_genes
TMPRSS11F	rand_ch_genes
C4orf46	rand_ch_genes
CFI	rand_ch_genes
ARHGEF38	rand_ch_genes
ASIC5	rand_ch_genes
UGT2A2	rand_ch_genes
AC126283.2	rand_ch_genes
FLT4	rand_ch_genes
DNAH5	rand_ch_genes
SOX30	rand_ch_genes
JADE2	rand_ch_genes
COL23A1	rand_ch_genes
PRDM6	rand_ch_genes
TCOF1	rand_ch_genes
P4HA2	rand_ch_genes
DELE1	rand_ch_genes
GEMIN5	rand_ch_genes
SEMA6A	rand_ch_genes
CEP72	rand_ch_genes
C7	rand_ch_genes
GHR	rand_ch_genes
MRPS27	rand_ch_genes
APBB3	rand_ch_genes
BTNL8	rand_ch_genes
MSH3	rand_ch_genes
RAD50	rand_ch_genes
PPWD1	rand_ch_genes
C9	rand_ch_genes
ATP10B	rand_ch_genes
ARAP3	rand_ch_genes
MYOT	rand_ch_genes
FASTKD3	rand_ch_genes
EPB41L4A	rand_ch_genes
BHMT2	rand_ch_genes
HSD17B4	rand_ch_genes
CCNB1	rand_ch_genes
IL6ST	rand_ch_genes
ADAM19	rand_ch_genes
OSMR	rand_ch_genes
PPIP5K2	rand_ch_genes
BDP1	rand_ch_genes
TSLP	rand_ch_genes
FEM1C	rand_ch_genes
CXCL14	rand_ch_genes
DDX46	rand_ch_genes
ADAMTS12	rand_ch_genes
PARP8	rand_ch_genes
SPEF2	rand_ch_genes
PLEKHG4B	rand_ch_genes
CDH12	rand_ch_genes
GRAMD2B	rand_ch_genes
SLC26A2	rand_ch_genes
LSM11	rand_ch_genes
HK3	rand_ch_genes
MGAT4B	rand_ch_genes
ELOVL7	rand_ch_genes
RANBP3L	rand_ch_genes
AGGF1	rand_ch_genes
SCGB3A2	rand_ch_genes
CMYA5	rand_ch_genes
NSA2	rand_ch_genes
SLC6A18	rand_ch_genes
IL31RA	rand_ch_genes
ANKRD55	rand_ch_genes
NSD1	rand_ch_genes
BTNL9	rand_ch_genes
ACTBL2	rand_ch_genes
RGS14	rand_ch_genes
HARS1	rand_ch_genes
EMB	rand_ch_genes
C5orf34	rand_ch_genes
ZNF131	rand_ch_genes
DMXL1	rand_ch_genes
PHYKPL	rand_ch_genes
FAM153B	rand_ch_genes
RXFP3	rand_ch_genes
DDX41	rand_ch_genes
SLC36A2	rand_ch_genes
RGS7BP	rand_ch_genes
TMEM232	rand_ch_genes
TBC1D9B	rand_ch_genes
CPLANE1	rand_ch_genes
FCHSD1	rand_ch_genes
FAM169A	rand_ch_genes
RANBP17	rand_ch_genes
PCDHA7	rand_ch_genes
PCDHA5	rand_ch_genes
SLCO6A1	rand_ch_genes
ITGA1	rand_ch_genes
ARHGEF28	rand_ch_genes
KIF4B	rand_ch_genes
PCDHGC5	rand_ch_genes
EIF4EBP3	rand_ch_genes
PCDHAC1	rand_ch_genes
PCDHGB6	rand_ch_genes
PCDHGA8	rand_ch_genes
PCDHGB7	rand_ch_genes
ANKHD1-EIF4EBP3	rand_ch_genes
PCDHGA4	rand_ch_genes
AC116366.2	rand_ch_genes
TFAP2D	rand_ch_genes
REV3L	rand_ch_genes
PGM3	rand_ch_genes
UBR2	rand_ch_genes
ROS1	rand_ch_genes
UHRF1BP1	rand_ch_genes
OSTM1	rand_ch_genes
EFHC1	rand_ch_genes
ITPR3	rand_ch_genes
DSP	rand_ch_genes
CEP85L	rand_ch_genes
MCM9	rand_ch_genes
GABRR2	rand_ch_genes
OPRM1	rand_ch_genes
SLC26A8	rand_ch_genes
ZNF451	rand_ch_genes
BAG2	rand_ch_genes
RAB23	rand_ch_genes
ASCC3	rand_ch_genes
BVES	rand_ch_genes
GPLD1	rand_ch_genes
CRYBG1	rand_ch_genes
ACOT13	rand_ch_genes
SLC17A2	rand_ch_genes
FIG4	rand_ch_genes
UNC93A	rand_ch_genes
SLC22A2	rand_ch_genes
CCND3	rand_ch_genes
PRPH2	rand_ch_genes
CUL9	rand_ch_genes
SENP6	rand_ch_genes
VEGFA	rand_ch_genes
CCN6	rand_ch_genes
ENPP5	rand_ch_genes
PRSS16	rand_ch_genes
TBX18	rand_ch_genes
ADGB	rand_ch_genes
AKAP7	rand_ch_genes
PLEKHG1	rand_ch_genes
ABCC10	rand_ch_genes
UNC5CL	rand_ch_genes
DNAH8	rand_ch_genes
TREM1	rand_ch_genes
MEA1	rand_ch_genes
COL21A1	rand_ch_genes
RIOK1	rand_ch_genes
DEK	rand_ch_genes
ERMARD	rand_ch_genes
ULBP3	rand_ch_genes
CEP162	rand_ch_genes
NMBR	rand_ch_genes
FOXF2	rand_ch_genes
MDC1	rand_ch_genes
FAM8A1	rand_ch_genes
SLC17A4	rand_ch_genes
TPBG	rand_ch_genes
TBC1D32	rand_ch_genes
RNF217	rand_ch_genes
PNLDC1	rand_ch_genes
VIP	rand_ch_genes
SLC22A3	rand_ch_genes
UTRN	rand_ch_genes
AK9	rand_ch_genes
RAET1L	rand_ch_genes
ZSCAN12	rand_ch_genes
SLC35A1	rand_ch_genes
SAMD3	rand_ch_genes
PI16	rand_ch_genes
KIF6	rand_ch_genes
FAM83B	rand_ch_genes
THEMIS	rand_ch_genes
ZC3H12D	rand_ch_genes
TMEM151B	rand_ch_genes
TDRD6	rand_ch_genes
POU3F2	rand_ch_genes
RFX6	rand_ch_genes
THBS2	rand_ch_genes
TREML4	rand_ch_genes
EYS	rand_ch_genes
ZNF292	rand_ch_genes
ZKSCAN3	rand_ch_genes
L3MBTL3	rand_ch_genes
HSD17B8	rand_ch_genes
BTNL2	rand_ch_genes
NOTCH4	rand_ch_genes
SKIV2L	rand_ch_genes
SLC44A4	rand_ch_genes
LSM2	rand_ch_genes
MSH5	rand_ch_genes
MPIG6B	rand_ch_genes
LY6G6F	rand_ch_genes
MICA	rand_ch_genes
DHX16	rand_ch_genes
TAAR9	rand_ch_genes
CFB	rand_ch_genes
AL645922.1	rand_ch_genes
LY6G6D	rand_ch_genes
ERVFRD-1	rand_ch_genes
LY6G6F-LY6G6D	rand_ch_genes
MUC22	rand_ch_genes
CROT	rand_ch_genes
ASB4	rand_ch_genes
KDM7A	rand_ch_genes
PHTF2	rand_ch_genes
SCIN	rand_ch_genes
NUB1	rand_ch_genes
NPC1L1	rand_ch_genes
CHPF2	rand_ch_genes
TBXAS1	rand_ch_genes
PARP12	rand_ch_genes
SEMA3C	rand_ch_genes
LRCH4	rand_ch_genes
ZCWPW1	rand_ch_genes
LAMB4	rand_ch_genes
DLD	rand_ch_genes
DNAH11	rand_ch_genes
STEAP1B	rand_ch_genes
HOXA6	rand_ch_genes
COBL	rand_ch_genes
PLEKHA8	rand_ch_genes
EPHB6	rand_ch_genes
HSPB1	rand_ch_genes
EIF3B	rand_ch_genes
HYAL4	rand_ch_genes
MEOX2	rand_ch_genes
POU6F2	rand_ch_genes
AEBP1	rand_ch_genes
PMS2	rand_ch_genes
KIAA1549	rand_ch_genes
LRRC61	rand_ch_genes
CPA4	rand_ch_genes
CDHR3	rand_ch_genes
FOXP2	rand_ch_genes
IFT22	rand_ch_genes
IRF5	rand_ch_genes
SUMF2	rand_ch_genes
DPP6	rand_ch_genes
ARPC1B	rand_ch_genes
KRBA1	rand_ch_genes
CCDC146	rand_ch_genes
KCP	rand_ch_genes
NUP42	rand_ch_genes
AOAH	rand_ch_genes
TBRG4	rand_ch_genes
HUS1	rand_ch_genes
NACAD	rand_ch_genes
VWDE	rand_ch_genes
IGFBP3	rand_ch_genes
EPHA1	rand_ch_genes
NOM1	rand_ch_genes
LRGUK	rand_ch_genes
NUP205	rand_ch_genes
SLC37A3	rand_ch_genes
TSPAN33	rand_ch_genes
CPA5	rand_ch_genes
PKD1L1	rand_ch_genes
FAM131B	rand_ch_genes
PPP1R35	rand_ch_genes
STK17A	rand_ch_genes
COG5	rand_ch_genes
NEUROD6	rand_ch_genes
STEAP1	rand_ch_genes
CDCA7L	rand_ch_genes
DNAAF5	rand_ch_genes
MPLKIP	rand_ch_genes
MUC17	rand_ch_genes
TMEM196	rand_ch_genes
AMZ1	rand_ch_genes
DNAJC30	rand_ch_genes
ABCA13	rand_ch_genes
ITPRID1	rand_ch_genes
ZNF467	rand_ch_genes
UPP1	rand_ch_genes
MACC1	rand_ch_genes
IKZF1	rand_ch_genes
PCLO	rand_ch_genes
TRRAP	rand_ch_genes
ZNF138	rand_ch_genes
GSTK1	rand_ch_genes
HOXA4	rand_ch_genes
ZNF277	rand_ch_genes
TYW1	rand_ch_genes
SLC35B4	rand_ch_genes
GPC2	rand_ch_genes
FAM133B	rand_ch_genes
LRRD1	rand_ch_genes
MGAM	rand_ch_genes
POM121C	rand_ch_genes
AC004922.1	rand_ch_genes
ANK1	rand_ch_genes
NSMAF	rand_ch_genes
MYOM2	rand_ch_genes
MSR1	rand_ch_genes
ADAM28	rand_ch_genes
TAF2	rand_ch_genes
CPSF1	rand_ch_genes
CDH17	rand_ch_genes
ZFHX4	rand_ch_genes
ZDHHC2	rand_ch_genes
FZD3	rand_ch_genes
TRPA1	rand_ch_genes
STK3	rand_ch_genes
TNFRSF10A	rand_ch_genes
UBXN8	rand_ch_genes
ARHGEF10	rand_ch_genes
CLU	rand_ch_genes
SORBS3	rand_ch_genes
MTUS1	rand_ch_genes
VPS13B	rand_ch_genes
E2F5	rand_ch_genes
TEX15	rand_ch_genes
RNF122	rand_ch_genes
DSCC1	rand_ch_genes
SULF1	rand_ch_genes
MCPH1	rand_ch_genes
MFHAS1	rand_ch_genes
PXDNL	rand_ch_genes
TRIM55	rand_ch_genes
FAM83A	rand_ch_genes
DPY19L4	rand_ch_genes
RAB11FIP1	rand_ch_genes
UNC5D	rand_ch_genes
FAM160B2	rand_ch_genes
SLC30A8	rand_ch_genes
CSMD3	rand_ch_genes
SPIDR	rand_ch_genes
GEM	rand_ch_genes
TMEM67	rand_ch_genes
SCARA3	rand_ch_genes
HTRA4	rand_ch_genes
CNGB3	rand_ch_genes
ESCO2	rand_ch_genes
ADCK5	rand_ch_genes
TRHR	rand_ch_genes
MSRA	rand_ch_genes
FAM91A1	rand_ch_genes
MCMDC2	rand_ch_genes
OPLAH	rand_ch_genes
FBXL6	rand_ch_genes
CDCA2	rand_ch_genes
POMK	rand_ch_genes
COL14A1	rand_ch_genes
ENTPD4	rand_ch_genes
PKHD1L1	rand_ch_genes
FBXO16	rand_ch_genes
KCNU1	rand_ch_genes
MROH5	rand_ch_genes
OC90	rand_ch_genes
PRKDC	rand_ch_genes
LRRC24	rand_ch_genes
AC100868.1	rand_ch_genes
MUSK	rand_ch_genes
CNTLN	rand_ch_genes
FRMPD1	rand_ch_genes
GBA2	rand_ch_genes
SMARCA2	rand_ch_genes
TBC1D2	rand_ch_genes
PRUNE2	rand_ch_genes
PTGR1	rand_ch_genes
SUSD1	rand_ch_genes
AMBP	rand_ch_genes
DOCK8	rand_ch_genes
LHX3	rand_ch_genes
GLIS3	rand_ch_genes
APBA1	rand_ch_genes
SETX	rand_ch_genes
EXOSC3	rand_ch_genes
TRPM6	rand_ch_genes
TJP2	rand_ch_genes
CNTRL	rand_ch_genes
GALNT12	rand_ch_genes
MLANA	rand_ch_genes
MRPS2	rand_ch_genes
CKS2	rand_ch_genes
OMD	rand_ch_genes
PRDM12	rand_ch_genes
PRRC2B	rand_ch_genes
HABP4	rand_ch_genes
CDK9	rand_ch_genes
ODF2	rand_ch_genes
ECPAS	rand_ch_genes
SMC2	rand_ch_genes
CDK5RAP2	rand_ch_genes
DMAC1	rand_ch_genes
CCL21	rand_ch_genes
CD72	rand_ch_genes
IGFBPL1	rand_ch_genes
DENND4C	rand_ch_genes
IFNK	rand_ch_genes
CEP78	rand_ch_genes
GSN	rand_ch_genes
MRRF	rand_ch_genes
WDR31	rand_ch_genes
POLE3	rand_ch_genes
CIZ1	rand_ch_genes
HMCN2	rand_ch_genes
C9orf85	rand_ch_genes
FBXW5	rand_ch_genes
SNAPC3	rand_ch_genes
CCDC171	rand_ch_genes
FXN	rand_ch_genes
KIF27	rand_ch_genes
SHOC1	rand_ch_genes
ZNF367	rand_ch_genes
TRMT10B	rand_ch_genes
NSMF	rand_ch_genes
SLC27A4	rand_ch_genes
ANKRD20A4P	rand_ch_genes
ABO	rand_ch_genes
ZDHHC21	rand_ch_genes
GRIN1	rand_ch_genes
C8G	rand_ch_genes
MAN1B1	rand_ch_genes
LCN15	rand_ch_genes
ADAMTSL1	rand_ch_genes
C9orf50	rand_ch_genes
ANKRD18A	rand_ch_genes
EHMT1	rand_ch_genes
LRRC26	rand_ch_genes
NUTM2G	rand_ch_genes
FOCAD	rand_ch_genes
NOXA1	rand_ch_genes
CCDC180	rand_ch_genes
VPS13A	rand_ch_genes
TPM2	rand_ch_genes
STKLD1	rand_ch_genes
OR13C3	rand_ch_genes
FAM205A	rand_ch_genes
ORM1	rand_ch_genes
ANKRD18B	rand_ch_genes
AL358113.1	rand_ch_genes
ALOX5	rand_ch_genes
AIFM2	rand_ch_genes
COL17A1	rand_ch_genes
GSTO2	rand_ch_genes
SEC61A2	rand_ch_genes
PFKP	rand_ch_genes
RHOBTB1	rand_ch_genes
SEC31B	rand_ch_genes
MYO3A	rand_ch_genes
WASHC2A	rand_ch_genes
PDLIM1	rand_ch_genes
CUBN	rand_ch_genes
PALD1	rand_ch_genes
LZTS2	rand_ch_genes
NPM3	rand_ch_genes
GBF1	rand_ch_genes
ANKRD26	rand_ch_genes
NEURL1	rand_ch_genes
PITRM1	rand_ch_genes
PPIF	rand_ch_genes
CFAP58	rand_ch_genes
SFRP5	rand_ch_genes
ANXA11	rand_ch_genes
LDB3	rand_ch_genes
PRXL2A	rand_ch_genes
PLAU	rand_ch_genes
SLC25A16	rand_ch_genes
ECHS1	rand_ch_genes
TUBGCP2	rand_ch_genes
DNAJC1	rand_ch_genes
MFSD13A	rand_ch_genes
MYOF	rand_ch_genes
TACC2	rand_ch_genes
ARL3	rand_ch_genes
EXOC6	rand_ch_genes
ADAMTS14	rand_ch_genes
COMMD3	rand_ch_genes
ANKRD30A	rand_ch_genes
ZEB1	rand_ch_genes
MPP7	rand_ch_genes
PCDH15	rand_ch_genes
DOCK1	rand_ch_genes
CDC123	rand_ch_genes
ITIH2	rand_ch_genes
MARVELD1	rand_ch_genes
PIK3AP1	rand_ch_genes
MARCHF8	rand_ch_genes
BMS1	rand_ch_genes
VWA2	rand_ch_genes
UBTD1	rand_ch_genes
HTRA1	rand_ch_genes
PCBD1	rand_ch_genes
WBP1L	rand_ch_genes
AFAP1L2	rand_ch_genes
HNRNPF	rand_ch_genes
FAM241B	rand_ch_genes
CFAP46	rand_ch_genes
JMJD1C	rand_ch_genes
WASHC2C	rand_ch_genes
ZFAND4	rand_ch_genes
SNCG	rand_ch_genes
SKIDA1	rand_ch_genes
PPA1	rand_ch_genes
RTKN2	rand_ch_genes
PTCHD3	rand_ch_genes
DMBT1	rand_ch_genes
ASAH2	rand_ch_genes
FAM53B	rand_ch_genes
PSAP	rand_ch_genes
NRAP	rand_ch_genes
ZNF511	rand_ch_genes
PAPSS2	rand_ch_genes
LDB1	rand_ch_genes
LIPN	rand_ch_genes
LIPJ	rand_ch_genes
MALRD1	rand_ch_genes
DNAJC9	rand_ch_genes
CCDC7	rand_ch_genes
HOGA1	rand_ch_genes
ZNF511-PRAP1	rand_ch_genes
USH1C	rand_ch_genes
POLA2	rand_ch_genes
CD44	rand_ch_genes
QSER1	rand_ch_genes
TRPM5	rand_ch_genes
NXPE1	rand_ch_genes
VWA5A	rand_ch_genes
SNX15	rand_ch_genes
ATG2A	rand_ch_genes
DCPS	rand_ch_genes
NRXN2	rand_ch_genes
APOA4	rand_ch_genes
KIAA1549L	rand_ch_genes
ACCS	rand_ch_genes
HPS5	rand_ch_genes
USP35	rand_ch_genes
SNX19	rand_ch_genes
TRIM6	rand_ch_genes
FRMD8	rand_ch_genes
LSP1	rand_ch_genes
PPFIA1	rand_ch_genes
RRP8	rand_ch_genes
ACY3	rand_ch_genes
TESMIN	rand_ch_genes
SWAP70	rand_ch_genes
ANO3	rand_ch_genes
NAT10	rand_ch_genes
BTG4	rand_ch_genes
C11orf1	rand_ch_genes
TMPRSS13	rand_ch_genes
PAMR1	rand_ch_genes
DGKZ	rand_ch_genes
TENM4	rand_ch_genes
INTS4	rand_ch_genes
HTR3B	rand_ch_genes
ATM	rand_ch_genes
TKFC	rand_ch_genes
FADS1	rand_ch_genes
ROM1	rand_ch_genes
MPZL2	rand_ch_genes
TMEM25	rand_ch_genes
MMP3	rand_ch_genes
DLG2	rand_ch_genes
DIXDC1	rand_ch_genes
EXT2	rand_ch_genes
GDPD5	rand_ch_genes
SIK3	rand_ch_genes
VPS11	rand_ch_genes
CEP295	rand_ch_genes
ADAMTS15	rand_ch_genes
ALKBH3	rand_ch_genes
MMP10	rand_ch_genes
SAAL1	rand_ch_genes
PATL1	rand_ch_genes
C2CD3	rand_ch_genes
SAC3D1	rand_ch_genes
SF1	rand_ch_genes
NFRKB	rand_ch_genes
CDC42BPG	rand_ch_genes
C2CD2L	rand_ch_genes
OR5T3	rand_ch_genes
CTSW	rand_ch_genes
SNX32	rand_ch_genes
GRK2	rand_ch_genes
GPR137	rand_ch_genes
SCUBE2	rand_ch_genes
RPS6KB2	rand_ch_genes
DEAF1	rand_ch_genes
PIDD1	rand_ch_genes
POGLUT3	rand_ch_genes
IGSF22	rand_ch_genes
CCDC89	rand_ch_genes
DNHD1	rand_ch_genes
HARBI1	rand_ch_genes
SLC36A4	rand_ch_genes
C11orf42	rand_ch_genes
OR52D1	rand_ch_genes
B4GALNT4	rand_ch_genes
C11orf54	rand_ch_genes
OVCH2	rand_ch_genes
ATL3	rand_ch_genes
MUC6	rand_ch_genes
SLC22A10	rand_ch_genes
IRF7	rand_ch_genes
LMNTD2	rand_ch_genes
DYNC2H1	rand_ch_genes
C11orf95	rand_ch_genes
TRIM64B	rand_ch_genes
SLC22A25	rand_ch_genes
MUC2	rand_ch_genes
VSTM5	rand_ch_genes
TRIM64C	rand_ch_genes
MFRP	rand_ch_genes
FDXACB1	rand_ch_genes
TRIM6-TRIM34	rand_ch_genes
VSIG10L2	rand_ch_genes
POLR3B	rand_ch_genes
VEZT	rand_ch_genes
LETMD1	rand_ch_genes
PKP2	rand_ch_genes
STYK1	rand_ch_genes
MON2	rand_ch_genes
EIF4B	rand_ch_genes
TM7SF3	rand_ch_genes
ERBB3	rand_ch_genes
KDM5A	rand_ch_genes
ACTR6	rand_ch_genes
BAZ2A	rand_ch_genes
ACACB	rand_ch_genes
TULP3	rand_ch_genes
SSH1	rand_ch_genes
ERGIC2	rand_ch_genes
SLC8B1	rand_ch_genes
RPH3A	rand_ch_genes
DAO	rand_ch_genes
ACSS3	rand_ch_genes
TNS2	rand_ch_genes
FOXM1	rand_ch_genes
ARHGDIB	rand_ch_genes
DDX55	rand_ch_genes
MDM1	rand_ch_genes
GAPDH	rand_ch_genes
PTPN6	rand_ch_genes
IQSEC3	rand_ch_genes
UTP20	rand_ch_genes
WASHC3	rand_ch_genes
CIT	rand_ch_genes
DDX54	rand_ch_genes
MMP19	rand_ch_genes
HOXC12	rand_ch_genes
IKZF4	rand_ch_genes
PZP	rand_ch_genes
BEST3	rand_ch_genes
CCNT1	rand_ch_genes
LRRIQ1	rand_ch_genes
TMTC1	rand_ch_genes
IPO8	rand_ch_genes
USP30	rand_ch_genes
ITGA7	rand_ch_genes
SLC26A10	rand_ch_genes
ISCU	rand_ch_genes
STAB2	rand_ch_genes
USP44	rand_ch_genes
PLXNC1	rand_ch_genes
B4GALNT3	rand_ch_genes
PIK3C2G	rand_ch_genes
CD27	rand_ch_genes
LRIG3	rand_ch_genes
PTPRQ	rand_ch_genes
NEDD1	rand_ch_genes
MAP3K12	rand_ch_genes
CSAD	rand_ch_genes
ABCB9	rand_ch_genes
C12orf45	rand_ch_genes
AMN1	rand_ch_genes
BICD1	rand_ch_genes
PFKM	rand_ch_genes
CFAP251	rand_ch_genes
LRRC43	rand_ch_genes
FMNL3	rand_ch_genes
RACGAP1	rand_ch_genes
OTOGL	rand_ch_genes
DEPDC4	rand_ch_genes
A2ML1	rand_ch_genes
MARS1	rand_ch_genes
MBD6	rand_ch_genes
KRT80	rand_ch_genes
TCTN2	rand_ch_genes
KRT75	rand_ch_genes
CLEC12A	rand_ch_genes
MUCL1	rand_ch_genes
ADAMTS20	rand_ch_genes
SLC2A14	rand_ch_genes
MYO1H	rand_ch_genes
RESF1	rand_ch_genes
A2M	rand_ch_genes
UNC119B	rand_ch_genes
ANO6	rand_ch_genes
CD163L1	rand_ch_genes
DNAJC22	rand_ch_genes
SLC17A8	rand_ch_genes
HOXC9	rand_ch_genes
ARL6IP4	rand_ch_genes
GALNT9	rand_ch_genes
SNRNP35	rand_ch_genes
KNTC1	rand_ch_genes
NOC4L	rand_ch_genes
FAM186A	rand_ch_genes
OVCH1	rand_ch_genes
CFAP54	rand_ch_genes
LRRK2	rand_ch_genes
SLC15A5	rand_ch_genes
NCOR2	rand_ch_genes
NACA	rand_ch_genes
MFAP5	rand_ch_genes
DNAH10	rand_ch_genes
CEP290	rand_ch_genes
RASSF9	rand_ch_genes
LRRC10	rand_ch_genes
LRCOL1	rand_ch_genes
ATXN2	rand_ch_genes
KRT6A	rand_ch_genes
MUC19	rand_ch_genes
FRY	rand_ch_genes
ATP12A	rand_ch_genes
HTR2A	rand_ch_genes
VWA8	rand_ch_genes
DGKH	rand_ch_genes
MEDAG	rand_ch_genes
MTRF1	rand_ch_genes
DNAJC15	rand_ch_genes
ATP7B	rand_ch_genes
CLYBL	rand_ch_genes
ABCC4	rand_ch_genes
XPO4	rand_ch_genes
TPTE2	rand_ch_genes
LMO7	rand_ch_genes
SLC46A3	rand_ch_genes
LNX2	rand_ch_genes
BRCA2	rand_ch_genes
ESD	rand_ch_genes
FOXO1	rand_ch_genes
SACS	rand_ch_genes
CENPJ	rand_ch_genes
MICU2	rand_ch_genes
UPF3A	rand_ch_genes
CBY2	rand_ch_genes
ATP4B	rand_ch_genes
NEK5	rand_ch_genes
AL592490.1	rand_ch_genes
SERPINE3	rand_ch_genes
PCDH20	rand_ch_genes
ANGEL1	rand_ch_genes
SPATA7	rand_ch_genes
PTPN21	rand_ch_genes
PSEN1	rand_ch_genes
EXD2	rand_ch_genes
CMA1	rand_ch_genes
RPGRIP1	rand_ch_genes
CEP170B	rand_ch_genes
RBM23	rand_ch_genes
PYGL	rand_ch_genes
KIAA0586	rand_ch_genes
DAAM1	rand_ch_genes
ISM2	rand_ch_genes
CEP128	rand_ch_genes
PSMC1	rand_ch_genes
PAPLN	rand_ch_genes
CHD8	rand_ch_genes
PCK2	rand_ch_genes
DCAF4	rand_ch_genes
VSX2	rand_ch_genes
NRDE2	rand_ch_genes
BMP4	rand_ch_genes
ADCY4	rand_ch_genes
HEATR5A	rand_ch_genes
EAPP	rand_ch_genes
ACTR10	rand_ch_genes
CIDEB	rand_ch_genes
REM2	rand_ch_genes
TSSK4	rand_ch_genes
NAA30	rand_ch_genes
MBIP	rand_ch_genes
OXA1L	rand_ch_genes
MIDEAS	rand_ch_genes
FAM161B	rand_ch_genes
DHRS4	rand_ch_genes
CFL2	rand_ch_genes
TC2N	rand_ch_genes
ASPG	rand_ch_genes
PLD4	rand_ch_genes
PTGDR	rand_ch_genes
MGAT2	rand_ch_genes
GPR137C	rand_ch_genes
BTBD6	rand_ch_genes
JAG2	rand_ch_genes
BRF1	rand_ch_genes
SERPINA3	rand_ch_genes
NOP9	rand_ch_genes
CDC42BPB	rand_ch_genes
AP1G2	rand_ch_genes
HOMEZ	rand_ch_genes
CHMP4A	rand_ch_genes
AL136295.1	rand_ch_genes
OR11H12	rand_ch_genes
SLC24A1	rand_ch_genes
SPG21	rand_ch_genes
TRPM7	rand_ch_genes
CAPN3	rand_ch_genes
IQCH	rand_ch_genes
CEMIP	rand_ch_genes
RPAP1	rand_ch_genes
CEP152	rand_ch_genes
TJP1	rand_ch_genes
MYO5C	rand_ch_genes
VPS13C	rand_ch_genes
CALML4	rand_ch_genes
THAP10	rand_ch_genes
ADAMTS7	rand_ch_genes
ALPK3	rand_ch_genes
ITGA11	rand_ch_genes
UACA	rand_ch_genes
SMAD6	rand_ch_genes
DUOX1	rand_ch_genes
SLC28A2	rand_ch_genes
STRA6	rand_ch_genes
SPTBN5	rand_ch_genes
USP8	rand_ch_genes
SHF	rand_ch_genes
NIPA2	rand_ch_genes
ZSCAN29	rand_ch_genes
DUOX2	rand_ch_genes
BNIP2	rand_ch_genes
UBE2Q2	rand_ch_genes
MAN2C1	rand_ch_genes
ARRDC4	rand_ch_genes
CYP1A2	rand_ch_genes
MFGE8	rand_ch_genes
MCTP2	rand_ch_genes
CERS3	rand_ch_genes
ADAMTSL3	rand_ch_genes
WHAMM	rand_ch_genes
RNF111	rand_ch_genes
MYO1E	rand_ch_genes
MEGF11	rand_ch_genes
STARD9	rand_ch_genes
PPP1R14D	rand_ch_genes
CATSPER2	rand_ch_genes
MESP1	rand_ch_genes
VPS39	rand_ch_genes
EPB42	rand_ch_genes
TERB2	rand_ch_genes
ADAL	rand_ch_genes
JMJD7-PLA2G4B	rand_ch_genes
MINAR1	rand_ch_genes
FOXB1	rand_ch_genes
STARD5	rand_ch_genes
ARNT2	rand_ch_genes
SYNM	rand_ch_genes
REC114	rand_ch_genes
FAN1	rand_ch_genes
GANC	rand_ch_genes
GOLGA6B	rand_ch_genes
KBTBD13	rand_ch_genes
PLA2G4B	rand_ch_genes
AGBL1	rand_ch_genes
AC084756.2	rand_ch_genes
BAIAP3	rand_ch_genes
TMEM159	rand_ch_genes
MVP	rand_ch_genes
RIPOR1	rand_ch_genes
ACSM2B	rand_ch_genes
SLC12A3	rand_ch_genes
RGS11	rand_ch_genes
PALB2	rand_ch_genes
HSD17B2	rand_ch_genes
LPCAT2	rand_ch_genes
TNRC6A	rand_ch_genes
ABCC6	rand_ch_genes
PHKB	rand_ch_genes
TSNAXIP1	rand_ch_genes
SETD6	rand_ch_genes
MPG	rand_ch_genes
NME4	rand_ch_genes
SLC7A5	rand_ch_genes
PIEZO1	rand_ch_genes
PRSS33	rand_ch_genes
HMOX2	rand_ch_genes
RPGRIP1L	rand_ch_genes
RNF40	rand_ch_genes
SLC12A4	rand_ch_genes
GFER	rand_ch_genes
PKMYT1	rand_ch_genes
METTL26	rand_ch_genes
ERN2	rand_ch_genes
KIAA0513	rand_ch_genes
ITGAX	rand_ch_genes
ZFHX3	rand_ch_genes
ADAMTS18	rand_ch_genes
TLCD3B	rand_ch_genes
DOC2A	rand_ch_genes
CMIP	rand_ch_genes
FBRS	rand_ch_genes
ITGAD	rand_ch_genes
FCSK	rand_ch_genes
DNAH3	rand_ch_genes
SLC5A11	rand_ch_genes
ZDHHC1	rand_ch_genes
WDR90	rand_ch_genes
HS3ST6	rand_ch_genes
CDH16	rand_ch_genes
DPEP2	rand_ch_genes
MVD	rand_ch_genes
CDT1	rand_ch_genes
SRRM2	rand_ch_genes
MLKL	rand_ch_genes
KCNG4	rand_ch_genes
PDILT	rand_ch_genes
UMOD	rand_ch_genes
ITGAM	rand_ch_genes
SHCBP1	rand_ch_genes
VAT1L	rand_ch_genes
CES2	rand_ch_genes
PRSS36	rand_ch_genes
APOBR	rand_ch_genes
ZFP90	rand_ch_genes
PDIA2	rand_ch_genes
ZNF267	rand_ch_genes
SLX4	rand_ch_genes
ERI2	rand_ch_genes
METTL9	rand_ch_genes
CES1	rand_ch_genes
C16orf96	rand_ch_genes
DNASE1	rand_ch_genes
PTX4	rand_ch_genes
HP	rand_ch_genes
SMIM22	rand_ch_genes
PKD1L3	rand_ch_genes
PAGR1	rand_ch_genes
LIG3	rand_ch_genes
MYH13	rand_ch_genes
DNAH9	rand_ch_genes
SCN4A	rand_ch_genes
MRC2	rand_ch_genes
NME1-NME2	rand_ch_genes
UTP18	rand_ch_genes
HEATR6	rand_ch_genes
ST6GALNAC1	rand_ch_genes
ST6GALNAC2	rand_ch_genes
SCARF1	rand_ch_genes
ZZEF1	rand_ch_genes
ITGAE	rand_ch_genes
MYO15A	rand_ch_genes
APOH	rand_ch_genes
UNC13D	rand_ch_genes
KRT23	rand_ch_genes
CRYBA1	rand_ch_genes
RUNDC3A	rand_ch_genes
RAD51C	rand_ch_genes
KRT37	rand_ch_genes
CDK5RAP3	rand_ch_genes
RECQL5	rand_ch_genes
INTS2	rand_ch_genes
CHRNE	rand_ch_genes
DHX58	rand_ch_genes
KAT2A	rand_ch_genes
CNTNAP1	rand_ch_genes
ALOX12	rand_ch_genes
MYH1	rand_ch_genes
MYH2	rand_ch_genes
MED1	rand_ch_genes
WNK4	rand_ch_genes
USP6	rand_ch_genes
PLD2	rand_ch_genes
QRICH2	rand_ch_genes
RHBDF2	rand_ch_genes
C1QL1	rand_ch_genes
TNS4	rand_ch_genes
TOP2A	rand_ch_genes
SERPINF1	rand_ch_genes
TRIM47	rand_ch_genes
MPRIP	rand_ch_genes
C17orf80	rand_ch_genes
SGSM2	rand_ch_genes
ABCA8	rand_ch_genes
PTRH2	rand_ch_genes
ZMYND15	rand_ch_genes
MINK1	rand_ch_genes
SAT2	rand_ch_genes
CCDC40	rand_ch_genes
CARD14	rand_ch_genes
TRIM65	rand_ch_genes
CEP131	rand_ch_genes
STAC2	rand_ch_genes
ANKFN1	rand_ch_genes
SLC5A10	rand_ch_genes
ABCA10	rand_ch_genes
ABCA5	rand_ch_genes
PRPSAP1	rand_ch_genes
CXCL16	rand_ch_genes
CCDC182	rand_ch_genes
ACSF2	rand_ch_genes
CDK12	rand_ch_genes
ENGASE	rand_ch_genes
EVPL	rand_ch_genes
KRT19	rand_ch_genes
KRT20	rand_ch_genes
SLFN12	rand_ch_genes
RAB37	rand_ch_genes
JUP	rand_ch_genes
RNF213	rand_ch_genes
KRT28	rand_ch_genes
PPM1E	rand_ch_genes
ALOX15B	rand_ch_genes
MEIOC	rand_ch_genes
ZFP3	rand_ch_genes
CUEDC1	rand_ch_genes
AATK	rand_ch_genes
RNF135	rand_ch_genes
USH1G	rand_ch_genes
TSEN54	rand_ch_genes
MXRA7	rand_ch_genes
GALR2	rand_ch_genes
OTOP3	rand_ch_genes
NAA38	rand_ch_genes
DNAH2	rand_ch_genes
ADAP2	rand_ch_genes
SPPL2C	rand_ch_genes
CCDC137	rand_ch_genes
RAD51D	rand_ch_genes
KIF18B	rand_ch_genes
KRT26	rand_ch_genes
SMYD4	rand_ch_genes
C17orf58	rand_ch_genes
KRT14	rand_ch_genes
KRT12	rand_ch_genes
KRTAP9-8	rand_ch_genes
SIRT7	rand_ch_genes
DNAH17	rand_ch_genes
FBF1	rand_ch_genes
KIF19	rand_ch_genes
SHPK	rand_ch_genes
CSHL1	rand_ch_genes
KRT40	rand_ch_genes
KRT25	rand_ch_genes
TRIM16	rand_ch_genes
NME2	rand_ch_genes
AC005324.3	rand_ch_genes
GH1	rand_ch_genes
MYH4	rand_ch_genes
AC004223.3	rand_ch_genes
HEATR9	rand_ch_genes
RASL10B	rand_ch_genes
RDM1	rand_ch_genes
GGNBP2	rand_ch_genes
AC127029.3	rand_ch_genes
DSG2	rand_ch_genes
LAMA3	rand_ch_genes
CTDP1	rand_ch_genes
LMAN1	rand_ch_genes
MOCOS	rand_ch_genes
NDC80	rand_ch_genes
ATP8B1	rand_ch_genes
ST8SIA5	rand_ch_genes
POLI	rand_ch_genes
RBBP8	rand_ch_genes
RIOK3	rand_ch_genes
TTR	rand_ch_genes
NFATC1	rand_ch_genes
EMILIN2	rand_ch_genes
DSG3	rand_ch_genes
ELP2	rand_ch_genes
GREB1L	rand_ch_genes
PPP4R1	rand_ch_genes
CCDC178	rand_ch_genes
LOXHD1	rand_ch_genes
HDHD2	rand_ch_genes
ZSCAN30	rand_ch_genes
SIGLEC15	rand_ch_genes
PIGN	rand_ch_genes
C18orf63	rand_ch_genes
FUZ	rand_ch_genes
WIZ	rand_ch_genes
NLRP2	rand_ch_genes
PNPLA6	rand_ch_genes
MRI1	rand_ch_genes
PNKP	rand_ch_genes
HOMER3	rand_ch_genes
ABCA7	rand_ch_genes
GPATCH1	rand_ch_genes
PTPRH	rand_ch_genes
COL5A3	rand_ch_genes
CNOT3	rand_ch_genes
FLT3LG	rand_ch_genes
CERS4	rand_ch_genes
PLEKHG2	rand_ch_genes
MAST3	rand_ch_genes
CATSPERG	rand_ch_genes
CBARP	rand_ch_genes
TULP2	rand_ch_genes
ECH1	rand_ch_genes
KLC3	rand_ch_genes
TRMT1	rand_ch_genes
AKAP8	rand_ch_genes
ILVBL	rand_ch_genes
ANKRD27	rand_ch_genes
TIMM50	rand_ch_genes
DYRK1B	rand_ch_genes
CCNP	rand_ch_genes
TGFB1	rand_ch_genes
NOP53	rand_ch_genes
CEACAM5	rand_ch_genes
MEIS3	rand_ch_genes
GRIN2D	rand_ch_genes
SIGLEC6	rand_ch_genes
LILRB5	rand_ch_genes
PDE4C	rand_ch_genes
PCSK4	rand_ch_genes
GRIN3B	rand_ch_genes
B9D2	rand_ch_genes
KIR2DL1	rand_ch_genes
SH2D3A	rand_ch_genes
BCL2L12	rand_ch_genes
ADGRE2	rand_ch_genes
KRI1	rand_ch_genes
SLC44A2	rand_ch_genes
KLK10	rand_ch_genes
SHC2	rand_ch_genes
DOCK6	rand_ch_genes
BST2	rand_ch_genes
ATG4D	rand_ch_genes
ZC3H4	rand_ch_genes
NAPSA	rand_ch_genes
NFIC	rand_ch_genes
TPGS1	rand_ch_genes
DUS3L	rand_ch_genes
LMTK3	rand_ch_genes
WTIP	rand_ch_genes
NLRP12	rand_ch_genes
FBN3	rand_ch_genes
CPAMD8	rand_ch_genes
SHKBP1	rand_ch_genes
RDH13	rand_ch_genes
ZNF333	rand_ch_genes
CCDC105	rand_ch_genes
MFSD12	rand_ch_genes
U2AF1L4	rand_ch_genes
THAP8	rand_ch_genes
TMEM143	rand_ch_genes
KASH5	rand_ch_genes
TMC4	rand_ch_genes
ZNF526	rand_ch_genes
DNAAF3	rand_ch_genes
DAPK3	rand_ch_genes
ATF5	rand_ch_genes
RLN3	rand_ch_genes
ZNF440	rand_ch_genes
WDR87	rand_ch_genes
ZNF57	rand_ch_genes
NLRP13	rand_ch_genes
PCP2	rand_ch_genes
MYPOP	rand_ch_genes
ZNF575	rand_ch_genes
PHLDB3	rand_ch_genes
C19orf18	rand_ch_genes
SIX5	rand_ch_genes
FAM187B	rand_ch_genes
GGN	rand_ch_genes
NLRP8	rand_ch_genes
SYCN	rand_ch_genes
NLRP11	rand_ch_genes
ZNF154	rand_ch_genes
ARHGAP45	rand_ch_genes
ZNF571	rand_ch_genes
ZSCAN4	rand_ch_genes
MUC16	rand_ch_genes
CAPN12	rand_ch_genes
ZNF93	rand_ch_genes
NLRP9	rand_ch_genes
ZNF829	rand_ch_genes
RGS9BP	rand_ch_genes
CYP4F3	rand_ch_genes
VSIG10L	rand_ch_genes
LILRB4	rand_ch_genes
EPOR	rand_ch_genes
HAPLN4	rand_ch_genes
NWD1	rand_ch_genes
ZNF559	rand_ch_genes
ZNF569	rand_ch_genes
ZNF429	rand_ch_genes
ZNF441	rand_ch_genes
CYP2B6	rand_ch_genes
CYP2A13	rand_ch_genes
ZNF607	rand_ch_genes
TEX45	rand_ch_genes
LILRB3	rand_ch_genes
PSG5	rand_ch_genes
RGL3	rand_ch_genes
ONECUT3	rand_ch_genes
ZNF726	rand_ch_genes
PSG1	rand_ch_genes
PSG2	rand_ch_genes
PSG4	rand_ch_genes
ZNF350	rand_ch_genes
IFNL4	rand_ch_genes
FCGBP	rand_ch_genes
AC008397.2	rand_ch_genes
RIPOR3	rand_ch_genes
BCAS1	rand_ch_genes
CST7	rand_ch_genes
CBFA2T2	rand_ch_genes
MYH7B	rand_ch_genes
LZTS3	rand_ch_genes
KIZ	rand_ch_genes
ESF1	rand_ch_genes
CFAP61	rand_ch_genes
TRMT6	rand_ch_genes
SGK2	rand_ch_genes
IFT52	rand_ch_genes
SALL4	rand_ch_genes
SLC17A9	rand_ch_genes
PTK6	rand_ch_genes
FERMT1	rand_ch_genes
SAMHD1	rand_ch_genes
PAK5	rand_ch_genes
MAPRE1	rand_ch_genes
PXMP4	rand_ch_genes
GCNT7	rand_ch_genes
CTCFL	rand_ch_genes
SNX21	rand_ch_genes
ARFGEF2	rand_ch_genes
ZNFX1	rand_ch_genes
PTGIS	rand_ch_genes
CDH26	rand_ch_genes
MKKS	rand_ch_genes
BPIFB1	rand_ch_genes
CEP250	rand_ch_genes
HELZ2	rand_ch_genes
GATA5	rand_ch_genes
LAMA5	rand_ch_genes
BPIFA3	rand_ch_genes
PCED1A	rand_ch_genes
ADAM33	rand_ch_genes
CNBD2	rand_ch_genes
SPINT4	rand_ch_genes
TGM6	rand_ch_genes
ZSWIM1	rand_ch_genes
NANP	rand_ch_genes
L3MBTL1	rand_ch_genes
STMN3	rand_ch_genes
ZNF335	rand_ch_genes
UCKL1	rand_ch_genes
EFCAB8	rand_ch_genes
RBM12	rand_ch_genes
AL031681.3	rand_ch_genes
COL6A2	rand_ch_genes
TRPM2	rand_ch_genes
DOP1B	rand_ch_genes
TMPRSS15	rand_ch_genes
ADAMTS5	rand_ch_genes
USP16	rand_ch_genes
BACH1	rand_ch_genes
ERG	rand_ch_genes
LCA5L	rand_ch_genes
RUNX1	rand_ch_genes
UBASH3A	rand_ch_genes
PDE9A	rand_ch_genes
LRRC3	rand_ch_genes
GRIK1	rand_ch_genes
ZBTB21	rand_ch_genes
COL18A1	rand_ch_genes
IGSF5	rand_ch_genes
BRWD1	rand_ch_genes
SETD4	rand_ch_genes
LTN1	rand_ch_genes
TPTE	rand_ch_genes
BID	rand_ch_genes
CLTCL1	rand_ch_genes
SELENOO	rand_ch_genes
P2RX6	rand_ch_genes
PES1	rand_ch_genes
SRRD	rand_ch_genes
TRIOBP	rand_ch_genes
TFIP11	rand_ch_genes
SLC5A4	rand_ch_genes
CYP2D6	rand_ch_genes
TCF20	rand_ch_genes
FBXO7	rand_ch_genes
HMOX1	rand_ch_genes
TTLL12	rand_ch_genes
PNPLA3	rand_ch_genes
FOXRED2	rand_ch_genes
TUBGCP6	rand_ch_genes
BAIAP2L2	rand_ch_genes
TTLL8	rand_ch_genes
PARVG	rand_ch_genes
RGL4	rand_ch_genes
VPREB1	rand_ch_genes
PRR14L	rand_ch_genes
KREMEN1	rand_ch_genes
NDUFA6	rand_ch_genes
EFCAB6	rand_ch_genes
TMPRSS6	rand_ch_genes
CCDC157	rand_ch_genes
PLXNB2	rand_ch_genes
SFI1	rand_ch_genes
CPT1B	rand_ch_genes
CCDC188	rand_ch_genes
MIF	rand_ch_genes
ARFGAP3	rand_ch_genes
SCARF2	rand_ch_genes
ZNF280B	rand_ch_genes
CDK11A	rand_possible_no_ch_genes
CLCA4	rand_possible_no_ch_genes
ADSS2	rand_possible_no_ch_genes
SOAT1	rand_possible_no_ch_genes
CROCC	rand_possible_no_ch_genes
WDR3	rand_possible_no_ch_genes
TGFBR3	rand_possible_no_ch_genes
HDAC1	rand_possible_no_ch_genes
DOCK7	rand_possible_no_ch_genes
GADD45A	rand_possible_no_ch_genes
NT5C1A	rand_possible_no_ch_genes
IGSF21	rand_possible_no_ch_genes
RSRP1	rand_possible_no_ch_genes
ARID1A	rand_possible_no_ch_genes
ADGRB2	rand_possible_no_ch_genes
RAB25	rand_possible_no_ch_genes
PTGFRN	rand_possible_no_ch_genes
GNL2	rand_possible_no_ch_genes
NIBAN1	rand_possible_no_ch_genes
LAMC1	rand_possible_no_ch_genes
PADI1	rand_possible_no_ch_genes
SYTL1	rand_possible_no_ch_genes
ITGA10	rand_possible_no_ch_genes
ALDH9A1	rand_possible_no_ch_genes
MAP3K21	rand_possible_no_ch_genes
AHCTF1	rand_possible_no_ch_genes
C8A	rand_possible_no_ch_genes
CYP4A22	rand_possible_no_ch_genes
DRAXIN	rand_possible_no_ch_genes
PGLYRP4	rand_possible_no_ch_genes
NAXE	rand_possible_no_ch_genes
ZC3H12A	rand_possible_no_ch_genes
THBS3	rand_possible_no_ch_genes
VANGL1	rand_possible_no_ch_genes
FCRL6	rand_possible_no_ch_genes
LAMB3	rand_possible_no_ch_genes
TMEM240	rand_possible_no_ch_genes
PADI6	rand_possible_no_ch_genes
RETSAT	rand_possible_no_ch_genes
CLASP1	rand_possible_no_ch_genes
NLRC4	rand_possible_no_ch_genes
PLCD4	rand_possible_no_ch_genes
QPCT	rand_possible_no_ch_genes
PLCL1	rand_possible_no_ch_genes
PCYOX1	rand_possible_no_ch_genes
ECRG4	rand_possible_no_ch_genes
TNFAIP6	rand_possible_no_ch_genes
MOGAT1	rand_possible_no_ch_genes
PXDN	rand_possible_no_ch_genes
ANKRD36	rand_possible_no_ch_genes
SELENOI	rand_possible_no_ch_genes
ASNSD1	rand_possible_no_ch_genes
NAB1	rand_possible_no_ch_genes
CDK15	rand_possible_no_ch_genes
ITPRID2	rand_possible_no_ch_genes
PTH2R	rand_possible_no_ch_genes
CCDC138	rand_possible_no_ch_genes
CCDC74A	rand_possible_no_ch_genes
ARHGAP25	rand_possible_no_ch_genes
KLF11	rand_possible_no_ch_genes
KIAA2012	rand_possible_no_ch_genes
TBC1D8	rand_possible_no_ch_genes
VIT	rand_possible_no_ch_genes
DLEC1	rand_possible_no_ch_genes
STAB1	rand_possible_no_ch_genes
SLC4A7	rand_possible_no_ch_genes
MCF2L2	rand_possible_no_ch_genes
COL7A1	rand_possible_no_ch_genes
ATP13A4	rand_possible_no_ch_genes
FANCD2	rand_possible_no_ch_genes
XPC	rand_possible_no_ch_genes
TRIM42	rand_possible_no_ch_genes
PRRT3	rand_possible_no_ch_genes
TASOR	rand_possible_no_ch_genes
SLC51A	rand_possible_no_ch_genes
TRANK1	rand_possible_no_ch_genes
ULK4	rand_possible_no_ch_genes
ZBBX	rand_possible_no_ch_genes
SLCO2A1	rand_possible_no_ch_genes
WDR49	rand_possible_no_ch_genes
B3GNT5	rand_possible_no_ch_genes
CCDC66	rand_possible_no_ch_genes
KBTBD12	rand_possible_no_ch_genes
OSTN	rand_possible_no_ch_genes
COL6A6	rand_possible_no_ch_genes
TTLL3	rand_possible_no_ch_genes
ARPC4-TTLL3	rand_possible_no_ch_genes
RUFY3	rand_possible_no_ch_genes
RFC1	rand_possible_no_ch_genes
SH3BP2	rand_possible_no_ch_genes
WFS1	rand_possible_no_ch_genes
DDX60	rand_possible_no_ch_genes
HERC6	rand_possible_no_ch_genes
KIAA1109	rand_possible_no_ch_genes
CORIN	rand_possible_no_ch_genes
SPATA4	rand_possible_no_ch_genes
TMPRSS11D	rand_possible_no_ch_genes
MAP9	rand_possible_no_ch_genes
ZCCHC4	rand_possible_no_ch_genes
NPNT	rand_possible_no_ch_genes
NFXL1	rand_possible_no_ch_genes
TLR1	rand_possible_no_ch_genes
BTC	rand_possible_no_ch_genes
AMBN	rand_possible_no_ch_genes
ADH1B	rand_possible_no_ch_genes
UGT2B15	rand_possible_no_ch_genes
CNGA1	rand_possible_no_ch_genes
C4orf54	rand_possible_no_ch_genes
CDHR2	rand_possible_no_ch_genes
MRPS30	rand_possible_no_ch_genes
SLC4A9	rand_possible_no_ch_genes
POLK	rand_possible_no_ch_genes
SPINK5	rand_possible_no_ch_genes
OTULINL	rand_possible_no_ch_genes
IQGAP2	rand_possible_no_ch_genes
RNF44	rand_possible_no_ch_genes
SLC45A2	rand_possible_no_ch_genes
GPR151	rand_possible_no_ch_genes
SLC6A19	rand_possible_no_ch_genes
GPR150	rand_possible_no_ch_genes
PLCXD3	rand_possible_no_ch_genes
LRRC70	rand_possible_no_ch_genes
PCDHGA5	rand_possible_no_ch_genes
PCDHGB3	rand_possible_no_ch_genes
PCDHGB5	rand_possible_no_ch_genes
DEF6	rand_possible_no_ch_genes
EPB41L2	rand_possible_no_ch_genes
SRPK1	rand_possible_no_ch_genes
MED23	rand_possible_no_ch_genes
VNN1	rand_possible_no_ch_genes
CCDC170	rand_possible_no_ch_genes
TTLL2	rand_possible_no_ch_genes
USP45	rand_possible_no_ch_genes
KLHDC3	rand_possible_no_ch_genes
LTV1	rand_possible_no_ch_genes
TCTE1	rand_possible_no_ch_genes
MTFR2	rand_possible_no_ch_genes
TMEM200A	rand_possible_no_ch_genes
POLH	rand_possible_no_ch_genes
SLC22A1	rand_possible_no_ch_genes
ECT2L	rand_possible_no_ch_genes
DAXX	rand_possible_no_ch_genes
RPS10-NUDT3	rand_possible_no_ch_genes
NUDT3	rand_possible_no_ch_genes
CFTR	rand_possible_no_ch_genes
ABCB5	rand_possible_no_ch_genes
SLC25A13	rand_possible_no_ch_genes
ADCYAP1R1	rand_possible_no_ch_genes
SLC13A1	rand_possible_no_ch_genes
IQCE	rand_possible_no_ch_genes
CYP3A5	rand_possible_no_ch_genes
FKBP9	rand_possible_no_ch_genes
ASL	rand_possible_no_ch_genes
ADCK2	rand_possible_no_ch_genes
DMTF1	rand_possible_no_ch_genes
C7orf25	rand_possible_no_ch_genes
SPDYE1	rand_possible_no_ch_genes
GPNMB	rand_possible_no_ch_genes
MMD2	rand_possible_no_ch_genes
SLC12A9	rand_possible_no_ch_genes
GNAT3	rand_possible_no_ch_genes
TG	rand_possible_no_ch_genes
ZFAT	rand_possible_no_ch_genes
R3HCC1	rand_possible_no_ch_genes
TTI2	rand_possible_no_ch_genes
TATDN1	rand_possible_no_ch_genes
NAPRT	rand_possible_no_ch_genes
HEY1	rand_possible_no_ch_genes
LETM2	rand_possible_no_ch_genes
C8orf34	rand_possible_no_ch_genes
KCNB2	rand_possible_no_ch_genes
RP1L1	rand_possible_no_ch_genes
TOP1MT	rand_possible_no_ch_genes
NUGGC	rand_possible_no_ch_genes
CNOT7	rand_possible_no_ch_genes
C8orf89	rand_possible_no_ch_genes
NUDT18	rand_possible_no_ch_genes
PUM3	rand_possible_no_ch_genes
KANK1	rand_possible_no_ch_genes
FBXW2	rand_possible_no_ch_genes
ACO1	rand_possible_no_ch_genes
TTF1	rand_possible_no_ch_genes
DDX31	rand_possible_no_ch_genes
USP20	rand_possible_no_ch_genes
CRB2	rand_possible_no_ch_genes
FANCC	rand_possible_no_ch_genes
CERCAM	rand_possible_no_ch_genes
TPRN	rand_possible_no_ch_genes
SSNA1	rand_possible_no_ch_genes
DPP7	rand_possible_no_ch_genes
MAMDC4	rand_possible_no_ch_genes
EXD3	rand_possible_no_ch_genes
NEBL	rand_possible_no_ch_genes
CDH23	rand_possible_no_ch_genes
SFXN3	rand_possible_no_ch_genes
SORCS1	rand_possible_no_ch_genes
LOXL4	rand_possible_no_ch_genes
ADAM8	rand_possible_no_ch_genes
C10orf90	rand_possible_no_ch_genes
TYSND1	rand_possible_no_ch_genes
MMRN2	rand_possible_no_ch_genes
FZD8	rand_possible_no_ch_genes
THNSL1	rand_possible_no_ch_genes
AKR1C1	rand_possible_no_ch_genes
AKR1C3	rand_possible_no_ch_genes
DGAT2	rand_possible_no_ch_genes
PYGM	rand_possible_no_ch_genes
POU2AF1	rand_possible_no_ch_genes
KBTBD4	rand_possible_no_ch_genes
TPH1	rand_possible_no_ch_genes
CNGA4	rand_possible_no_ch_genes
LGALS12	rand_possible_no_ch_genes
RNF121	rand_possible_no_ch_genes
SORL1	rand_possible_no_ch_genes
PGGHG	rand_possible_no_ch_genes
EIF3M	rand_possible_no_ch_genes
ZC3H12C	rand_possible_no_ch_genes
PDE3B	rand_possible_no_ch_genes
NLRP14	rand_possible_no_ch_genes
NLRX1	rand_possible_no_ch_genes
PPP1R32	rand_possible_no_ch_genes
DEUP1	rand_possible_no_ch_genes
INPPL1	rand_possible_no_ch_genes
RNF214	rand_possible_no_ch_genes
NLRP6	rand_possible_no_ch_genes
CSTF3	rand_possible_no_ch_genes
PKP3	rand_possible_no_ch_genes
SELENOH	rand_possible_no_ch_genes
ANO2	rand_possible_no_ch_genes
KDM2B	rand_possible_no_ch_genes
P3H3	rand_possible_no_ch_genes
CAMKK2	rand_possible_no_ch_genes
KRT18	rand_possible_no_ch_genes
WNT5B	rand_possible_no_ch_genes
C2CD5	rand_possible_no_ch_genes
IRAG2	rand_possible_no_ch_genes
PPHLN1	rand_possible_no_ch_genes
SLCO1B1	rand_possible_no_ch_genes
ALDH1L2	rand_possible_no_ch_genes
APPL2	rand_possible_no_ch_genes
LGR5	rand_possible_no_ch_genes
POC1B	rand_possible_no_ch_genes
SLC39A5	rand_possible_no_ch_genes
IQCD	rand_possible_no_ch_genes
MYO1A	rand_possible_no_ch_genes
SOAT2	rand_possible_no_ch_genes
CCDC63	rand_possible_no_ch_genes
ACSM4	rand_possible_no_ch_genes
KLRF2	rand_possible_no_ch_genes
FBXL3	rand_possible_no_ch_genes
IFT88	rand_possible_no_ch_genes
SETDB2	rand_possible_no_ch_genes
PPP2R3C	rand_possible_no_ch_genes
NIN	rand_possible_no_ch_genes
ACIN1	rand_possible_no_ch_genes
APEX1	rand_possible_no_ch_genes
NEK9	rand_possible_no_ch_genes
TEP1	rand_possible_no_ch_genes
ABHD12B	rand_possible_no_ch_genes
TTC6	rand_possible_no_ch_genes
CBLN3	rand_possible_no_ch_genes
SLC24A4	rand_possible_no_ch_genes
IPO4	rand_possible_no_ch_genes
SLC25A29	rand_possible_no_ch_genes
NEDD4	rand_possible_no_ch_genes
SEMA7A	rand_possible_no_ch_genes
ULK3	rand_possible_no_ch_genes
PLIN1	rand_possible_no_ch_genes
AKAP13	rand_possible_no_ch_genes
IGDCC3	rand_possible_no_ch_genes
NOX5	rand_possible_no_ch_genes
RHBDF1	rand_possible_no_ch_genes
MAPK3	rand_possible_no_ch_genes
NUP93	rand_possible_no_ch_genes
NDRG4	rand_possible_no_ch_genes
HAS3	rand_possible_no_ch_genes
PMM2	rand_possible_no_ch_genes
NOL3	rand_possible_no_ch_genes
NOB1	rand_possible_no_ch_genes
TBX6	rand_possible_no_ch_genes
HIRIP3	rand_possible_no_ch_genes
TXNDC11	rand_possible_no_ch_genes
LRRC36	rand_possible_no_ch_genes
BICDL2	rand_possible_no_ch_genes
SLC38A8	rand_possible_no_ch_genes
ABCA3	rand_possible_no_ch_genes
AC099489.1	rand_possible_no_ch_genes
SPG7	rand_possible_no_ch_genes
LASP1	rand_possible_no_ch_genes
SARM1	rand_possible_no_ch_genes
KIAA0100	rand_possible_no_ch_genes
SMG6	rand_possible_no_ch_genes
TEX14	rand_possible_no_ch_genes
METTL16	rand_possible_no_ch_genes
ITGB4	rand_possible_no_ch_genes
MYH8	rand_possible_no_ch_genes
MAPK7	rand_possible_no_ch_genes
SMG8	rand_possible_no_ch_genes
RSKR	rand_possible_no_ch_genes
FASN	rand_possible_no_ch_genes
CCDC144A	rand_possible_no_ch_genes
BPTF	rand_possible_no_ch_genes
MYO1D	rand_possible_no_ch_genes
ALOXE3	rand_possible_no_ch_genes
PIPOX	rand_possible_no_ch_genes
SLC47A2	rand_possible_no_ch_genes
KRT10	rand_possible_no_ch_genes
KRTAP17-1	rand_possible_no_ch_genes
TRPV1	rand_possible_no_ch_genes
KIAA0753	rand_possible_no_ch_genes
TNFRSF13B	rand_possible_no_ch_genes
AC005726.1	rand_possible_no_ch_genes
PIK3R6	rand_possible_no_ch_genes
PIEZO2	rand_possible_no_ch_genes
ANKRD30B	rand_possible_no_ch_genes
CD22	rand_possible_no_ch_genes
HOOK2	rand_possible_no_ch_genes
DHDH	rand_possible_no_ch_genes
SYDE1	rand_possible_no_ch_genes
APLP1	rand_possible_no_ch_genes
CD33	rand_possible_no_ch_genes
TYK2	rand_possible_no_ch_genes
SULT2A1	rand_possible_no_ch_genes
SUGP1	rand_possible_no_ch_genes
EML2	rand_possible_no_ch_genes
TRPM4	rand_possible_no_ch_genes
ANGPTL6	rand_possible_no_ch_genes
ZSWIM4	rand_possible_no_ch_genes
BRD4	rand_possible_no_ch_genes
PWWP3A	rand_possible_no_ch_genes
NPHS1	rand_possible_no_ch_genes
NIBAN3	rand_possible_no_ch_genes
PSG6	rand_possible_no_ch_genes
ZNF439	rand_possible_no_ch_genes
C19orf71	rand_possible_no_ch_genes
SBSN	rand_possible_no_ch_genes
ZNF181	rand_possible_no_ch_genes
ZNF560	rand_possible_no_ch_genes
ZNF667	rand_possible_no_ch_genes
LILRA4	rand_possible_no_ch_genes
SIGLEC12	rand_possible_no_ch_genes
AC011455.2	rand_possible_no_ch_genes
SEC23B	rand_possible_no_ch_genes
C20orf85	rand_possible_no_ch_genes
PAX1	rand_possible_no_ch_genes
LPIN3	rand_possible_no_ch_genes
HSPA13	rand_possible_no_ch_genes
CFAP298	rand_possible_no_ch_genes
AIRE	rand_possible_no_ch_genes
TSPEAR	rand_possible_no_ch_genes
RIPK4	rand_possible_no_ch_genes
CFAP298-TCP10L	rand_possible_no_ch_genes
COMT	rand_possible_no_ch_genes
MMP11	rand_possible_no_ch_genes
SLC5A1	rand_possible_no_ch_genes
INPP5J	rand_possible_no_ch_genes
XPNPEP3	rand_possible_no_ch_genes
CRYBA4	rand_possible_no_ch_genes
